 ## # ##### #  ## ####  # ##### #### ####### #### ###### #### ### # ######## ##### ###  #####   ### 
#..#.#.....#.##..#....##.#.....#....#.......#....#......#....#...#.#........#.....#...##.....# #...#
 #.#...#.#......#..##.....##.#...##.###.#.#...##.#.####.#.##...#....#.####.#..###...#...#.##..#..#.#
 #.##.##..###.##..#..##.#...# #.#......#...#.#.###.#..#...#.##..#.#...#....#.#...#.#.##.#...#...#..#
#....##..##.#..#.# #....###..#...###.#..###..#.....##..###....#..# #.#.#.###.#.#.#.#.....#.#.###.#.#
#.##.#..#...#.##..#..###...#...##...#.#.#...##.##.#...#...#.#.##..#.#..#.#.....###..#.##...#......# 
 #.#.#.# #.##....#..##...#...###..#...#.#.###..#.#..##..#...#..##....#....#.#.#...#..#  #.#..####.# 
#..#.#..#....#####.##..###.##....##.#.#.#.#...#...#....#.##..#..####..#.#..#.#..#..#.# #..#.#...#..#
#.##..#.#.##.#.....#..#...#...#.##..#.#...#.##..#.#.#.#...##..##....#..#.#.#...# #.#..#..##..##..#.#
#.#..#......#..####.#.#.#.#.##.#...#..###.#....#...##.#.#...##...##.##.#.#.#.##.#..##..#...#.#..#..#
#...#..#####..#......#..#...#...#.#..#...#.#.##..##...#..#.#...##....#.#.#.#.#..#.#..#..###...#..#.#
#.#.#.#.....#..#.###..#..###..#.## #...#...##...#...##..#..#.##..#.#...#.#...#.#..#.#.#....#.#..#..#
#.##..#.###.##.#.#.#.#.#...#.#....#.#.#.##....## #.#...#..##...#....###...#.#....#.....###.....##.# 
#...##..#......#...#....##.#..#.#....#....#.##..#...#.#.#.#.#.#..###...##..#..###.####...#.#.##...# 
 ##.#..#..#.##..##.##.#.#..##..# ###.#.##.#...#...#.#...#...#..###...#.#.#.#.#.........#.#.##...#..#
#...##.#.#...###.#...##..#...#.##......#..###..#.#..#.##.#.#.#.#...##..#...#.#.##.###.#..#..#.## #.#
#.##....#.###.....##...#..##.#...##.### #....#.#..#.#....#...#...##...#.#.#..#..#.#.##.#.#.##.#.#..#
#..#.##.......#.#...##.#.#.#..##...#...#.###.#..#..#.##.#..#.#.##...##..#...#.#.#.#....#..#...#..#.#
#.#....######.#..###...#.#..#...##.#.#.#...#.##..#......#.#...#...#.#.#...#....#...#.##.#.#.##.#...#
#.###.#......# #.#...###..#..#.#...#.#...#.#...#.####.###.#.#.#.##.....### #.#.#.##.....#.#..#..#.# 
#...##..####..#..#.##...#..#.#..##.#..#.##..#.#......##...#..#....#####...#.#....#..#.#.#.##..#...# 
 ##...#.#...#..#...#.#.#.#...##..#..#.##...#..######....##.#.#.###......#.#..####.#.#.#.#....#..##.#
#.#.#...#.#...#..##.......##..##..#.#...#.##.#......##.#.#...#.#...##.#.#.##......#..#...#### #....#
#..#.###..#.##..#..#.#.##...#....##..##..##..#.##.#...#...##.#.#.##..#.#...###.#.#.#.#.#.....#.###.#
 #.....#.#..#.#...#..#..##.#.####..#..##....#..#..###...#...##.#...#....##....##.....#..####...#...#
#.#.##..#..#...#.#..#.#...#..#....#.#..##.#.#.##.#...###.##.....#.# #.#...#.#...#.#.#.#.#...#.#..## 
#...#..#..#..#.#..#...#.#...#..##...##...#....#..#.#.#.....#.#.##..#..##.#...##.#..#..#...#.##..##.#
 #.##.#..#..#...#..##..#..###.#...#...##..###.###..#..##.#.##....#..#..#..#.##..##..#..####...#....#
#..#..#.##.#..#..#...##..#....#.###.#...#....#....#.#..#..#...###.#..#..#..#...#.#.#.#.....##..###.#
#.#..#..#...#..##..##...#..#.#.#...#.##..##.#..###...#..#...##......#..#.#.#.##..#.#.#.##.#...#..#.#
#..#..#.#.#..#....#...#.#.#....#.#......#.....#...##.#.#..##...#####..#....#...#.#.#...#..#.#..#...#
 #.#.##..#..#.#.##.#.# ##..####..##.###..#.###.#.#...#..#..#.###....##..#.#..##..#..#.#..#...#.#.## 
#..#...#.#.#...#...#..#...#.....#..#...#..#....#...#..#..#.#.#...##....#.##.#...# #.#..#.###..##...#
 #..##.#.#...#.#.#..#...#.#.#.###.#..##..#..##...#..#..#..##..###...###.....#.##.##..#..#...#...##.#
#.#...#..#.###.#..#.#.##.##..#......#.#.##.##..##.#..#.##...#.....##....####..#.....#..#..#..##..#.#
#...##..#.#....#.##..#......#..#.###..#...#...##...#..#...###.#.###..##.#...#...####..#.#..#..#.#..#
 #.#...#...##.#..#.#...#####..##.....#.##...##...#...#..##.....#....#..#..#.#.##.....#...#..#.#.#.# 
 #...###.#....##.#.####.....#...#.##.....##...###..###.##..####..#.#.#.#.##......####..#..#.#...#..#
#..##.....####...#......##.#..###...#.##...#.#...##....#..#.....#.##...#...######.....#.#...#### #.#
#.##..##.#.....#..#####...#..#...##.#..#.#.#.#.#.#..#.#..#.#.###.....#..##.#......##.#...#.#....#..#
#...#.#...####.#.#.....##...#..#...#..#...#..#.#...#.#..#....#.#.####..##..#.##.#..##..#.#.#.##.#.# 
 ##..#..#.....#....###.#..#.#.#.##.#.#..##..##.#.##....# ###.#...#..#.#...#..#.#.#..#.##..#..#..#.# 
#.#.#..# ####..#.#.#...#.#.#..#.#..#..##...##...#...### #....#.##..#..##.# #.#.....##...#...#..##..#
#.#..#..#....#..#..#.##....#.#..#.#.#..#.##...#.#.##...#..###...#.#..#....##.#.#.##..#.#.##.#.##..# 
#..#..###.##..#.###....##.#...#...#...#..#.#.#..#.#..#.#.#....#....#.#.#.#...#..#...#..#...#..#..#.#
#.#.#.....#..#.....#.#..##..#..#.##.#..#...#..##..#.##.#.#.###.#.#.#...##..#..#...#..#.#.#..#...##.#
#...######..##.#.#.#..#...#..##..#...#.###.#.#...# #...#..#....#..# ###.#.#.##.#.#..#..##.#..#.#...#
#.##......#...#.#..####.#..#.#..##.#.#...#.#.#.#..#..#.#.##.##..#..#....#......#..##..#....#..#..#.#
#.#..##.#..##.#.#.#....# #.#..#...##..#.#..#....#...#.#.....#.#..#..#.#..#.##.#..#...#..##..#...##.#
#...#.#..#..#.#....#.#..#..##..##...###..#.####..###...#.#.#..#.#..#..####.#..#.##.##..#..#..##...# 
#.##...#..###..#.#.#..#.#.#..#.#.##....#.#.....##....#..#....#..#.##.#....#..# #...#.#...#.#..#.#.# 
#....#..#....#.#..#..##.#..#...#...###...#.##.#...### #.#.#.#.#.#....#.##...# #..##....##...#.#.#..#
 #.## #.#.##...##.#.#.....#..##..#.#...#.#..###.##...##..# #....#.##.#...##..#..#.#.##.#..##..#..#.#
#.#..##..#..###.#.#..#.###.#.#.#..#..##.#..#....#..#...#.##..#.#.#....##.#.#.#.#..#.#..#.#...#.##..#
#..#...#...##...#..#..##...#.#..#...#...#.##.##.#.#.##.#...#..#...#.#.#..#...#.##....#.#.#.##...#.# 
 #..##...#.#..#...# #.#..#...##...##..###.#..#.#....#...##...#..#..#..#.#.#.##...##.#..#...#..#...# 
  #..##.#.#..# ###.#..#.#..##...##...#....#.#....##.#.##.####..##.#..##....##.##...#..#..#...#.##..#
   #....#..#..#......#.##.#..#.##..##..###...###...#..#.....#.##..#.##.###.....#.#..#..##..##..#..# 
  #..###.#..#.#.#.#.#.....#.#..#..#.#.#...##....##.#.##.#.#...#..#..#.....#.##..# #.##...##...#..#.#
 #..#.....#.#..#..#..#.###..#.#..#..#...#...###.# #..#..##.#.#..##.#..#.#.#..##..##..#.#.#..#...##.#
#..#.#.##...#.#..#..#..#.#.#..#.#..# ###.#.#..#..#..#..#...#.#.##...#..#...#..##...#..#..#.# ###...#
#.#..#..###...#.#..##.#....#.#....#.#....#.##..#..#...#..#.#.#...##...#..#..#...###..#..##..#....#.#
#..#...#...##..#..#...#.##.#.#.##.....##.#..#.#.#..###..#..#.#.#...###.#..#..##...#.#..#..#.#.#.#..#
#.#..#.#.#...#...#.#.##.#..#.##  ###.# #..#.#....#.#...#..#...#.##.#....#..#.#.##.#...#.#.#..#...#.#
#.#.#.#..#.#..#.#......#..##...##....##..##.#.##.#.#.##..#..#.#.#..#.###..#.#...#.####....##..##..# 
#..#....#..#.#.#..####..#.#.##....#.#...#...#...#..#..##..###.#..#.#...#.##.#.#.#.....#.#...#.# #..#
#.#..###.##..#.#.#...##.#...#..#.#.##.##..##.##..#..#...#.....##....##.#....#.#.#.#.#....####..# #.#
#...#..#....#..#.#.#..#..##...#.#.....#..#....##..#..##..#####.#.###....#.##..#..# #..###....#..#..#
 #.#..#..###.#...#..#..#...#.#...#.###..#.#.#...#..#.#.#.#...#...#...###...#.#.#..#..#....#.#.#.##.#
#.#..#..#....#.##..#.#..##..#..#.#...#.#....###...##...#..##...##..###...##..#..#.##..#.##....#..#.#
#...#..#.###.#..#.##..#.#..#..##..#.#..#.#.#...##...##..#..#.##...#....#.#..#.#.#...#.#..#.##.##.#.#
 #.##.#......##.#....#...#...#..#.#.#.# #..#.##.#.#...#..#.#.#..#...#.##.#.#.....##.#..#.#.##..#...#
#..#..#.##.#..#.####..##..###..#..###..#..#......#..###.#..#..##..##.#...#..#.##..#...#..#...#..##.#
#.#..#..#..####.....##...#....#..#...#.#.#..#.##...#....#.#.#.#..##...#.#.#.#..#.#.##..#.###..##.#.#
#..#..#..#......#.#..#.#.#.#.##.##.#.....###..#..##..###..#.#..##...#..#.....###....##.#....#....#.#
#.# #..##..##### #.#...#..#..#..#..####.#...#..##..#.#..#.#.##....##.#.#.#.##...#.#..#.##.#..##.#..#
#..#.#...#.#....#...#.#.#...##.##.#....##.#..#....##.#.#..#...#####..#.##..#..#.#.###....#..#.#...# 
 #....##.#.#.#.#..#.###...#.#..#..#.##.#..##..##.#...#...#.##.......#.....##.#..#.....#.#..#...#.#.#
  #.##.#.#...#.#.#.....##..#..##.#..#....#..#..#.#.##.#.#...#.##.###..#.#.#..##..###.#.#..#..#..#..#
 #.....#.#### #..#.###...#.#.#...#.#.##.#..# #.##..#......#.#..#....#..#.#..#..#....#..#.#.#..#..#.#
#..##.##.....#..#.#...##.#.#...##..#...#..#.#.....#..######..#.####...#....#.#..###...#..#...#.#.#.#
#.#.#.#.##.#..#.....#..#..#..###..#..#...#...###.##.#......#..#...####..#.#....#...##...#..##..#.#.#
#.#.......#.#.#.#.###.#.#..#.#...#..#.##..##....#...#.####.##...#......#.#..#.#..#...###.#...#.....#
#.#.#.###...#..#.#....#.##..#..##..#....#..###.#..##..#..#...###.######...#.#.#.#..#.#....#.#.####.#
#.#..#...##..#.#...#.#...#.#..#...#..#.#.#.....#.#...#.#..##.....#......#.#.#..##.#..#.#.#........# 
#.#.#..#.#..#..###..#.##.....#..###.##.#..##.##..#.#.#.#.#..##.#...##.##..#.##....#.# #...#.##.##.# 
 #..#.#..#.#.#....#.#...###.#..#....#..##..#.#..#.#........#....###..#...#....#.##...##.#.#...#.#..#
#..#..#.##...####.#...#....##.#.#.##.#..#.#..#.##...######.##.##..##.#.##.##.#..#.##....#..#.#...#.#
 #.##.#...##....#.#.###.##.#..#....#...#..#.##...##.#....#..#.#..#...#.#...#.#.#....####.#..#..#.#.#
 #....###...#.#.#..#...##..#.#..##.#.###.#..#.##...##.##..##..#.##.#.#..##...#..#.#.......#.#.#..#.#
#..###...#.#..##..#..#....##..#.#..#.#...#.#....##....# #....#.....#..#.#..##.#.#..##.#.##..#..#.#.#
#.##...##..#.#.#.##.#.####..#.#.#.##...##....###..####.#.#.##.##.#.#.##..##.....##..#.#..#.##.#....#
#.#..#.#..#....#.#..#....#.#..#.#...##..#.#.#...#.#.......#.....#..#...#...#.###..#.#..##..#..#.#.# 
#..###.#.#..#.#..#.#.#.##....#.#..#...###..##.#.....###.#..##.#..#..##..##.#.#.#.#.#..#...#..#.##..#
#.#....#.##.##..#..#.#..#.###...##..##...#.#..###.##...# #..#.##..##...##..#.#.......#..###.#....#.#
#...#.##...#...#.#....#...#.#.#...#.#..#.#...#..#..#.#..##.#....#....#.#..#...#.#.#.#..#....##.#.#.#
 ###....##.#.##...#.#..#.##...#.#.#...#...#.##.#.#....#...#..##..####.#..# ##.#..# #..#..###...#...#
#...#.##.#.#....#.##..#....#.#.#...####.#.##......###..##.##...#.#.....#.##...##..##.#..#..#.##.### 
#.#......#...#.#.....#..##...#...#......#....##.#....#..#....#.#...#.#......#...#......# #.........#
 # ###### ### # ##### ##  ### ### ###### ####  # #### ## #### # ### # ###### ### ######   ######### 
