#########   ########
#.......#####......#
#..................#
#.......#####......#
#########   ###.###
              #.#
              #.#
              #.#
              #.#
              #.#
              #.#
###############.##############
#............................#
#............................#
#............................#
#............................#
#............................#
#............................#
#............................#
#............................#
##############################