 ###  # ##### ###### ### ########## ##### ####### ##  ######## ######## ## #### #####  # # ##### ## 
#...##.#.....#......#...#..........#.....#.......#..##........#........#..#....#.....##.#.#.....#..#
 ##.....#.##.#.##.#.#.#.#.#.###.###..#.#.#.###.#...#...#.#.##..#.#####..#...##...###.......##.#..#.#
#.#####.##...#.#..#...#.#..#...#...#.#.#.#...#..##.#.##.#...##...#....#.#.###.#.#...######.#..##...#
#.....#...#.#..#.#..###..#...#...#.#.#.#..#.# #..##..#..#.#..####..##.#..##...#.###.#....#.#.#...#.#
#.###.###.#...#..#.#...#..#.##.##..#.#.#.#...#.#...#...##..##.....#.#..#....#.#...#...##.#.#..#.#.# 
#...#...#..#.#.#..##.#..#.##....#.#..#.##..#....##..#.##.#....#.#.#...#..#.##.#.#..#.#...#..#.#.#..#
#.#..##..#.#....#....#.#....###.#...##....#.##.#..#.......#.##.#..#.##..# #...#..#..#.##.#.##.#..#.#
#.###...##..###.###.#..#.##....#..##..#.###......#.####.#..#....#.#...##.#..##.##..#...#......#.#..#
 #...##...#...#....#.#..#.####.#.#...#.#...#.#.##......##.#..##.##..#.#...#..#....##.#..#.####..#.# 
#..#.# #.# ##..###...##.#......#...###.#.#..#...#.#.##.#...#..#...###...#..#.##.#.#...#..#...##...# 
#.#...#...#...#...##..#.#.#.### #.#......##..##.#..#.#.#.##.#..##....#.# #.#....##..#..#.#.#...##..#
#.#.#.#.#.#.## #.##..#..#.##...#.#..#####.##..#..#.#.#.#.....#...###.##.#..##.#..#.#..#..#.#.#..##.#
#..##...#.#...#..#..#..##....#...#.##...#...#..##..#.#.#.###..#.#.........#....#.#..##..#...##.#...#
 #...##..#..##..#..#.#.#.#### #.#..#..###.#..#.#..#..#..#...#.#.#.#######.#####.#..#...#.##...#..## 
 #.#...#.#.#...#..#....#.#...#..#.#..#....#.##.#.# #...##.#.##...#.......#......#.#..###....#..#.#.#
#...##.#.#.##.#.#..#.#.#...#.#.#...#.#.###.....#..#..##...#..#.##..#####...####.#..#....#.##.#.....#
#.#.#..#.#..#...##..##.#.#..#...#.##...#..#.### #.#.#..#.#.#.#..#.#.....###...#..#.#.##..#....#.#.# 
#.###.##.#.#..#..#.#...#..#.#.##..#..##.#..#...#..#.#.##.#...##.....#####...#..#....#..#...##.###..#
 #....#..#.##..#...#.##.#.#.#....#..#....#.#.#...#....#..#.#...###.#......##.#..#.#..#..####.....#.#
#..###.#.#...##..###.#....#..####.#..#.#...#..##..#.##..#.#.##....##.#####....#..#.#...#....#.##.## 
 #......#.##...#.#...#.#.#.#.......#..# #.# #.#.#.#....##.....###....#....#.#...#...##..#.#.#..#...#
 #.#.##...#.##..##.##..#...##.####..#..#...#..#.#..##.#...#.##...####..#.#..####..#.#..#..#..#..##.#
#..##...##....#....#..#.##..##...###.#.##.##.#...#..##..###....#.#....# #..#.....#...###.#.#..#.#..#
 #..#.#.#..#.#.####..#..#.#..#.#.....#..#.....##..#...#.#..##.##.#.##..##.#..##.#.##.....#..#.###.# 
#.#.#..#..#.......#.#..#...#...#####..#..####..##..##.#...#.#...#..#.#....#.# #.#...###.#..##......#
#.#.##..#..##.###.#..#.#.#..##......#..#.....#...#..#..##...#.#...#...#.##...#..#.#.#..#.#...###.#.#
#.#...#..#..#.#.#..#...#.##...##.### #..##.#..##..#.#.#..##..#.####.#.#.#..###.#..#..#.....#.#.#.#.#
#.###..#...#..#.#.#.##.#..#.#..##...#..#..##.#.##...#..#...#...#....#.#..###...#.#..#.#.##.##...#..#
#....#.####.#.#.....#..##.#..#....#.##...#...#...#.#.#..#.#..##..###..##.....#.#..#.#.....#...#...# 
 #.###......#.####.#..#.#.##.#####.....##..##.#.#....##.#.#.#...#....#..###.##.##.#..#.###..##.###.#
 #.....####.#....#..#...#...#....###.#.#..#.....#.#.#...#...#.##..###.#...##....#.##.#.....#.#...#.#
#..#.##...#..###.#.#.#.# ##...##....#.#..#.####..#..#.#..#.#..#..#....#.#....##.#..#.#####.....#...#
#.#...#.#.###....#...#..#.####..###...#.#.....##...#..##..#..#..#.#.#.#.#####..#.#.#......#####.##.#
 #.#.#..#...#.##..###.#.#......#...##.#.###.#...#.#.#..#.#..#..#.....#........#..#..###.#.#......#.#
#...#..# ##.#..###....#..#.####..#....#...#..#.#..#..#..#..#.#.####.##.##.###...#..#...#..#.#.###..#
#.#...#.#...##.....#.#..##.#...#..####.##..#.#..#...# #.#.#..#....#.#..#.#...##.#.##.#.#.#...#....# 
#.####...##...#####...#....#.#.##.#.....##...#.#.##..#..#..#..###.#...#....#...#.....#.#.#.#...#.#.#
#.....##...##.......##.##.#..#....#.#.#...###..#...#..#.#.#.#...#..###..##.#.##..#.##.#..###.#.##..#
 #.##.#..#.#..#.####......#.# #.#.#..# ##.#..#..#.# #.#...#...#..#.....#..#...#.#.#.....#...#.....# 
#..##..#.#..#..#...#.###.##..#...#.#..#....#..#.#.##...####.#..#.##.####.#..##..#...##.##.#.#.###..#
#.#..#.#..#...#..#...#..#...#..#.#..#.#.##...##.#....#.....##.##...#......#..#.#..#...#...#.##..##.#
#.#.#..##.####.#..###..#..##..#..#.##.#...###...#.#.# ####....#.##..#.##.#..#..#.#.##.#.#.#...#....#
#.#.#.#.#......##.#...#..#..##..#..#...##.....##.#.# #....##.##...#...#..#.#..##.....#..###.#..###.#
#...#.#..##.#.#...##.#..#.#...#...#..##..###.#.#....#..##...#...#..###..##..#...#.##...#...#..#...# 
 #.#...#.#.#..#.##...#.#..#.#..##.#.#...#...#....##...#..##.###..#....#...#.#.#.###..#.#.#..#...#..#
#...#.##...#.#..#..#.#...#...#.#..#.#.#..#.##.#.#..###.#..#....##..##...#.#....#...#..#...#..##.#.# 
#.###...##....#.#.#.#..#..##.#..###.#.#.#..#..#...#....##..#.#.#..#..###...####..#..#.#.#..#...#...#
 #...##.#..#.##.#....#..##...##.....#.#...#..#..##..##....#.##..#...#...#.#....#..#.#.#..##.##..##.#
#..#....#.#.#...#.##..#.#..##..###.#...##.#.#..#...#...#.#....#.#.##..#..#..##..#.#..# #.#....#..#.#
#.# #.#..#....##...#.#....#.##....##.#...#..#.##.#..#.#.#..##...#..#.#.#.#.#.##....#.##..#.#.# #.#.#
#..#.#.##..###.##.#...#.##...#.#.#...#.##..##.#...#..#....#..###.#.#.#.#.#.#...#.##.....#..#..#....#
 #.......#...#....#.#..#...#....##.##..#..#...#.## #.#.###..##.#...#.#.#.#...#..#...####..#.#..#.#.#
#..#####.###..#####..#..#.#..##.#...#.#..#..##....#..#.#..#.#..#.##..#.#.#.##.#.#.##.....#..#.#...# 
#.#....#....#......#..#..#..#.#...#.#...#.#...#.#.#.#..#.#....#....#.#.#.#....#.##...####..#..#.#..#
#..#.#.###.# #.###..#..#..#....#.#.#.###...##..#..#..#.#...##...#.#..#....#.#.#..#.##.....##.# #.#.#
 #..##...#..#.#...#.##..#..##.#.#........#...#.##..###.#.#..###..#..#.#.##.##..#.#.#.#.###....#...# 
#.#...##.#.#...#.##..#.##.#...#..#.#.#.##..#.#..##.....#..##...##..#..#......#.#.#.#.....#.#.#..#..#
#..##.##.#...#.....#...#..#.## #....#.#...#...#...#.#.#.#..#.#.#..# #..##.##..##.#.##.##.#.###.#.#.#
 #.#.....##.#.#.##..###..#..#.#..#.#..#.##..#.#.#..#....##.#.#..#..#..##.#.#.#...#...#.#.#.....#...#
#...##.#...#..#..##....#..#....##..#.#...###...#..#..##..#.#.##..#.#.##....#.#.##.##......#####..#.#
#.#...#.##...#.#...#.#..#..#.#.#..#...##....#.##.# ###..#..#..#.#..#....#.##...#....####.##...#.#..#
#..##....#.#....##..#..#.#..#..##...#...###.##....#...#.#.#.#.#.#.#.#.#..#...##..##.#..#...#.#..#.# 
 #.#..##..# ##.#...#..#...#..#...###.#.##.#..#.###..#.#..#....#...#...##.#.##...#.#...#.##.#.#.#...#
 #..#...#..#...#.##..#..#..#.###.#...#.....#.#.#...#..##..###..#.#..##...#.#..##...##....#.#.#.#### 
#.#..#.#.#.#.###...#.##.##.#...#...#.#.#.##..#...###.#.##.....#...#...#.#...#.#..#...###...#.#.....#
#.##.#.#.#.#....#.#...#...#.##.###.#.#..#...# ##.#...#..#.#.#..###..#.##..###.#.#..##...###...#.##.#
#....#.#.#.#.#.#..#.#..##....#....#..#.#..#..#..#..##.#....#..#...#.#....##...#..#..#.#...#.#..#...#
#.##.#.#....#..#.#...#....#.#.###.#.#.##.#.#..#..#.....#.#..###.#..# ###.#..##.#..#....##....#.#.#.#
#...#...###..#.#..##..##.#....#...#.#....#..#..#..#.##..#..#....##..#...##.#....#.#####..#.##..#.#.#
 #.#..##...##...#...##..#..##.#.##..#.##...#.#...#.##.#.###..#.#...#..#.#..#.#.#.......#..#...##..# 
#..#.#...#...##..##...#..#..#.#..#.##..####...#.#.....#.....# #..#.#.#..#.#...#..#.###..#.#.#...#..#
#.#....##.##....#..##..#..#..#.#.#...#.....#.#.#..#.#.#.####.#..# ##..#...#.#...#.#...#...#..##.##.#
#..##.#....#.#.#..#...#..#..#..#.#.#..#.##...#...#..#..#.....#.#.#...#.###...####.#.#..##..#.##..#.#
 #...#.#.#..#....#..##.#.#.#..#...# #.#.#.##...#.##..#...#.##....#.##.....##.#.......#...#.#...##..#
#.##...#..#..##.#..#.#...#...#.##..#..#.#.# ###...#.#..#.##...##.#..##.##..#.#.##.#.#.#.#.#..#..#.# 
#.# #.#.#.##...#..#....#..#.#.....#..##.#..#...##.#.#.#.#...##...##..#...#..#..#.#.#..#....#.##.#.# 
#..#....#..#.#..#.#.#.#.#...#.####..#....#.#.#...##..#....##.###...#.#.#..#...#......#.#.#..#...#..#
 #...##.##..# #...#.##...##.#.#..#.#.#.#...#.#.#...#.#.##.#.....#.##.#..## #.# #####...#.#.#..#.##.#
#..##.#..##.##..###....#...#..#.#.....#.###..##.##.#..# #...###..#....#...#.#.#......#..#....#.#...#
#.##...#..#...##...#### ##.#.#....#.#.#.....#....#..#..#.####..#...##..##.#.....##.#.#.#..#.#..#.#.#
#.#..#..#..##...#.#....#...#.#.###.#..#.#####.##.#.# #...#...#..#.##.#..#.#.####....#..#.#...#...#.#
#.#.#.#..##..##.#...##.#.###..#.....#...#.....#..#..#..#...#.##..#....#.#.#.#...####..#..#.#.#.##..#
#..#...#....#.#..##..#...#...#..###.#.##.#.#.#..##.#..#.#.#.....#..##.#...#...#.....#..#..#..#...#.#
 #..#.#.#.#....#...#.#.##..###.#..#..#......#.##...#.##...######..# #..###.#.#.####..#..#..##.##.#.#
 #.#......##.##.##..#...#.#....#.#.#.#.#.##....#.##..#..##.......#.#.#.#....#.....##.#.#.#.....#.#.#
#..#.#.##...#.....#..####...###..#...#..#..#.#.....##..#.#.#.#####...#...##..##.#..#..#...###.#..#.#
#.#.#....##...#.#.##.....###...#...##.#..#..# #.#.#...##.#..#......#..###..#.##..#..#...##....#.#..#
#.#...##..###..##...####.....###.##....#.##..#.#.#..#.....#.#.#.###.#...#.#.....##.#.#.##..####..## 
#..#.##.##...#...##....###.###...# #.#.....#.......#.#.###..#..#.....##....#####...#...#..#....#...#
 #.##......#..#.#..##.#....#...##.#...#.##.###.##.#..##...#..#.##.##.#.###.....#.##.#.##.##.##..##.#
 #...#.####..#...#....#.##.#.##.....#.###.....#.....#...#...##...#.....#..#.#.#..#....#..#....#....#
#.##.#.#....# #.#..##.#...#..#..#### #...##.#.#.#.##..##.###..##.#.###...# #..#.#..#.#..##.#.#.###.#
#..#...#.#.#.#..#.#.#..##...#.#.#...#..#...#.....#...#.#.#..#.#..#.#..##..#..#..##.#...##..##....#.#
 #..###..##...###.#.##.#.###...#..#..#..##..##.#.#.##......#....#..##...#..#..#...##.##...#...#.#..#
#.#....#...##.....#....#.#...#...#.#..#.#.#..##.#..#.#.#.##..###..#...#...#.#..##...#...##.#.#.#..# 
#.#.##..##...##.#.#.#.#....##.###..##.#.#.##....#.#.....#...#..#.#.#.#.##.#..#..###.###.#..#.....#.#
#.#.#.#..#.##...##...##.###.....##......#...###.#.#.##.#..#.##...#.#.#...#..#..#........##...#####.#
#......#......##...#....#...#.#....#.#.#..#.......#..#...#.....##......#...# #...#.#.#.#...#.......#
 ###### ######  ### #### ### # #### # # ## ####### ## ### #####  ###### ###   ### # # # ### ####### 
