#####################
#.............#.#...#
#.#.#.#####.###.#.#.#
#.#.#.....#.#.......#
###.#.#.#.#.###.#.###
#.....#.#.#...#.#...#
#.#.#.#.###.###.###.#
#...#.#.#.......#.#.#
###.#####.#.#.###.#.#
#.....#.....#.#.....#
#.#.#.#.#.#.###.#.###
#...#...............#
#####.#.#.#.###.#.###
#.#.....#.#.#.#.....#
#.#.#.#.#.###.#.#.#.#
#...................#
###.###.#.#.#.#.###.#
#.#.#.#.#.#.#...#.#.#
#.#.###.#############
#.............#.#...#
#.#.###.#.#.###.#.###
#...#.#.....#.......#
#.#.#####.#####.#.#.#
#.....#.....#.#.#...#
###.#####.###.#####.#
#.....#.#.#...#.#.#.#
#.#.#####.###.#.#.###
#.....#.....#.......#
#.#######.#.###.#.###
#.......#.....#.#.#.#
###.###.###.#####.#.#
#.....#.#.#.#.#.....#
#.#.#.###.#.#####.###
#.....#.......#.....#
#.#.###.#.#.###.###.#
#.#.#.#.....#.....#.#
#.#.#.###.#.###.#.#.#
#.....#.......#.....#
#.#.#.#.#.#.###.#.###
#.#.#.#.............#
#####################
