 # ##### #### ###### ## ######### #### #  ## ####   # ##### ## # ##### ########### # ###### ## ###  
#.#.....#....#......#..#.........#....#.##..#....# #.#.....#..#.#.....#...........#.#......#..#...# 
#..##.##..#.##.##.#...#..##.####..###......#..##..#...##.#..#....#.##...#.####.##.#...####.##...#..#
 #..#...#.#....##..##.#.#...#...#....#.##.#.#..##...#....##...##.#..###..#....#...#.#....#...##..#.#
 #.#..#....#.##..#...##.#.#.#.#..##.#...#....#...#.#.####..###.#..#...##.#.##.#.##..#.##..##...#.#.#
#..###..###..#.#..##.....#..#..#..#..###..##.###.#.#.#...#.#.....#.#.#...#...##..##..#..#.#..#...#.#
#.#...##...#.#...##.##.#..#..#..##.#....#..#...#.#.#...#.....####....#.###.#.#.#...#...#..#.#.#.#..#
#.#.#.#..#.#..#.##....#.## #.##.....###.##.#.#.#.#.#### #.###....#.#.#.#...#....##.#####.#.#...#.#.#
#...#...#..##.#....#.#....#....#.##...#..#.#..#..#.....#......##.##.#...###..##............#.#.#...#
 ###.#.#..#....#.#.##..##.#.##.#...#.#.#.#..#.#.# ####..######.#....#.##...###..#.###.#.#.#..#..#.# 
#..#..##.#..##...##...#...#..#..##.#.....##..#...#...##.#....#..#.#.#..#.#....#..#...#.#..#.#.#..#.#
 #...#...#.#..###...##..##..#.#.#...#.###..#...##..#....##.#...#.##..#.#..#.#.###..#.#...##.#..#.#.#
#..###.###..#.....#.#..#...#..#.#.##.#..#.#.#.#...# ####.#..#.#....#.#...#.##....#.#..#.#.....##...#
#.#....#...#..####.#..#..###.#..#.#...#......#..##.#.......# ##.##...##.#....###...##..##.#.###..#.#
#...###.##.#.##.....#..#.#....#.#...#.##.#.#...##..#.#.###..#...#.#.#....#.#....#.#..#....##...##..#
#.##......##....###.#.#....#.#..#.##.....#..###...#..#.#...#..##...#.###.###.##..# #..####...#....# 
#.#..#.##.#..#.#..#.#..##.#..#.#.#...#.##.##....##..#..#.###.#...#.....#.....#.#..##.##..#.##.#.#..#
#..#..#...####...#..##.#..###.....#.#.#.....#.##...##.#.##....#.#.####.##.###...#.......#..#....### 
 #..#.#.##....###..#.#..##...####..#..#.###.#....#.#..#....##...#....#...#....#..#.#.### #..#.##...#
#.#.#.#...#.#.....#...#..#.#.....#...#..#.#..####..#.#..#.#..#.#..##.###.#.###..#...#...#.#..##..#.#
#...#..##...####.##.#.##.#..#.#.#..##..##..#.#...##..#.#.#.#..#.##.......#...##.#.#.#.#.....#...##.#
#.##.#...#.#....#...#..#..#.###...# #.#...##...#...#.#.#.....#....##.#.#..##...#..##...####.#.##...#
#.#..#.##.#..#.#..##..#..#.....##..#..#.#...###..#.#.#..#.#.#..##.#...#.#...##...#...##....#....#.# 
#.##...#..#.##...#.#.#.#..#.##...##..#...#.#...##..#..#..#..#.#...####...##..#.##..#..#.##.#.##.#..#
#....##..#....#.#..#.#..#.#..#.##...# #.# #..#.#..# #.##...#..#.##.....#.#..#..#.#..#.#.#....#.#..# 
 ####..#...#.#..##.#.#.#...#.#....#.##...#..##...#.#....##..#.#.#..##.##..#.#.#..##.##...#.##...#..#
#....#...## #..#.#.#....#.#...####.....#..#...###...##.# #.#..#.#.##.#...#..#..#..#..#.#..#...#..#.#
#.##.#.#...#..##.....###...###....#####.#..##.....#..#..#...#.#.#.#..#.##..#..# #..#...#.##.## #.#.#
#.#...#.#.#..#...####...##....#.#.......###  ##### #..#...###.#.#...##.#..#..#.#.#..###.#...#.#..#.#
 #..#.#..#..#..#....#.#...#.#...#######....##.....#.#.##.##...#...##...#.##.#......##...#.##....##.#
 #.#..#.#..#..#.##.#...##.#..###.......###....###...#...#...###.##...##..#...##.##....###..#.#.#...#
#..#.##...#..#...#..#.#.#..##....#.##.#...#####.#.##..#...##...#...##...#.##...#  #.##...#.#..#..#.#
#.#.....###.##.#..##..#..#....##.#...##.#.......#...#..#.#...#...##..#.##...##.# #...#.#.#.##.#.#..#
#.##.#.#...#...##..#.#.#.##.##..#.##.....###.#.#.##.###...#.#.#.#...##...##..#..#..##..#.#..#.#..## 
#...#.#..#...##...#..#.....#...#....#####....##...#....##.#....#..#...##.#.#..#...# #.#..##.#..#...#
#.#.....# ###...#.#.#..#.#...#.#.##.#...#.#.#...#..###.#...#.##..# #.#.#...#.#..#..#..##....#.#..#.#
#..####..#...##.#.#..#..# #.#....#..##.#..##..#..#.#...#.#.#.#..#.#..#.###.#...#..#..#..##.##.#.#..#
#.#....##..#..#.#..#..#..#..###.#..#....#....#.#.#.#.##..##..#.#..#.#....#.##.#..#..##.#..#...#..#.#
#..#.#.#..##.#..#.##.#.#..#....##.#..#.#.##.#...#..#..#.#...##..#.#.#.##.#...#..#..#...##.#.## #.#.#
#.#..#.#.#.....# #...#.#.#.#.#.#..#.##.#...##.#...#.#..##.##..#...#...#..###.#.#..#..#....#...#.##.#
 ##.#....#.####.#..##..#.#..#..#.#.#...#.#...#..#....#.#....#...#..#.#..#.....#..#..#.###..##......#
#...###.#..#......#...##.#.#..##.#...#.#..##...#.##.#..#.###..#..###.#.#..####..# #.....##...###.#.#
#.##...##.#..#####.#.#.....#.#...##.#...#...###..#..#.#.....##..#...#..#.##....#.#..###...##...#..# 
#....#.#..#.#....#.....#####.#.#..#.#.#.###...##...#...#.##.#..##.#...##....###..#.#...##...##.##..#
#.###..###..###.##.#.#.#.....##.#....#.#...##..#.#.#.#..#.#.#.#...#.#.#.#.##....#..#.#.#.##.#...##.#
 #....#....#....#...#..#.#.##....#.##....#...#.##...#.#.#...#.#.##.#..#..#.#.#.#..##.#....#.#.##...#
#..##.#.####.#.##.#..##...#...##..#...### ##.#...##...#...##.#..#..#.#..#...#..#.##...#.#.#..##..## 
 #.#..#.#.....#....#..#.#.#.##.#.#..##...#...#.#...##.##.##....#..#...#...#.#.##...##.#.#..#....#..#
#..###..#.##.#..####.#...#..#....#.#...#.#.##...##..#..##...#.#..# #.#..##..#...##..##..#.#.####..# 
 #...#.#...##..#....#..###.#.##.##.#.## #..#..#..#.#.#...#.#...#..#...#.#..# #.#..#....#..#......#.#
 #.#...#.#....# #.#...#....#.......#...#..#..#.#.#.#..##.#.#.#..#...#.#..#..#...#..###.#.#.#.#.###.#
#...###.#.###..#...#.#..##.#.######..#.#.#..#...#..#.#...#..# #..###...#..#...#...#...#..#....#....#
#.#.#.#......##..#.#.#.##...#......#.#...#.#..#...#....##.#..#..#...##.##..#.#.##...#.#.# ###...#.# 
#.#.....####....#.#..#...#.##.####..#..#.##.#.###.#.##.#...#..###.#.#.....#.##....#..#..##...#.#..# 
#..####.#...##.#....#..#.##...#...#.#.#......#....#...#..#..#.....#..######....###.##..#...#.#.##..#
#.#....#..#..###.####.#...#.#.#.#.#..#..####...### ##.#.#..#..####.#.......##.##......#.#.#..#..##.#
 #..##..#..#....#....#.##.#..#..#..#..##....###...#.#.#..#...##.....#.####...#...##.##.....#..##...#
#..#.#.#.#..###..#.#......#.#..# #..#...#.#...#.#...#.#.# ###...##.#.#....##..##...#...##.#.#..#.#.#
#.#........#....#..####.#.#...#   #..##.#..##.## #.#..#..#....##...#...##.#.#...##.#.##.#.#.##...#.#
#.######.##.#.##..#......#.##..# #.#.##.#.#.#...#..#.#.#...###...##..##......#.#....#.....#...##.#.#
#.......#...#..#.#..#.#.#....#..#..##...#.#...#.#.##....####..#.# #.#..##.##.#.#.#.#..#### ##.#.#..#
#.#####.#.#.#.#..##..#.##.#.# #.#.#...##...###......#.#.#...#.#..#...#...#...#..#..#.##...#.....#.# 
#.#...#..#....#.#...#.....#..##...#.##.#.#....##.#.#.#..#.#....#...#.#.#..###.#..#...#..#...####..# 
#.##.#.#..##.#..#.#.#.####.#...#.#..#.....#.#...#..#.#.#...#.#..##.##..##......#.#.###.#..#.#....#.#
#..#....#.#...#.#..##.#.....#.#..#.##.#.#..#.##..#.#.#.#.#..#.#.#...#.#..#####.#..#....#.#..#.###..#
 #...##.#.###...#.#...#.#.#.#...#..#..##.#....#.#....#..# #....#..#.#..#.#...#..#.#.##.#.#.#..#.##.#
#.###...#...#.#..#..##..#..#.###..##.#....#.###..###..#..#..##..#.##.#.#..#.##.#..#...#..##..#.....#
#...#.##.##.#..#.#.#..##.#.#.....#.....###.#...#.#..#.##..###..#.....#..#......##..##.#.#...# #.#.# 
 ##.#.#...#.#.#.#....#...#.#.#.##.#.####.....#....#....#.#....#..#.##..#..#####...##..#...##.#..#..#
#...#..##.#..#...###...#...#..#.#...#....####..#.#..###..#.###..#.#...#..##...#.#.#..#.#.#....##.#.#
#.##.#..#..#...#....##.#.#.#.#..#.#.#.##.#...##.#..##.#.##...#.#....#.#.##..#..#..#.#...##.##......#
#.....#..#..#.#.###...#..##..#.##..#..#..#.#.....#....#...##....##.#.#..#..#.#...##...#...#  #.###.#
#.#.#.#.#..#.#..#.#.##..#.#.##....#..#.#.#..####..#.#.###.#..#.#...#.#.#.##...#.#..###.##..# #.#.#.#
 #.#..#..#....#...#..#.##.#.#..#.#..#..#..#.#...#..#....#..##..#.##..#.#....#.#..#...#...#..#..#.#.#
#....#..#..##..#.# #...#..#..#..#..# #...##..#.# #..#.#..#.#..#...#.#...##.#..##...#..##..#.#.#....#
#.#.#.#.#.#..#....#..###.#.#.##..#..#..##...#...#.#.#..##..#.#.#.#...#.#...#.#..#.# #...#.#.#.####.#
#.##........# #.#..##......#..#.#.#..##...###.#...#..##...#.##...#.##....##....#...#..#...#.#.....# 
#..#.#.####..#..##....#.#.# #..#...#....#....#..#..#.#..#.#....##..##.#.#...##.#.#..##.##.#..##.#..#
 #....#...###..#..####.#...#..#..#.##.##.#.#.#.#..#..#.#.#..###..#....###.##...#..#.#....# #...#..# 
#..###..#....#...#.....#.#.#.# #.#...#...#.#.#.#.##.##.#...##...#..#.#...##..##.###.#.##..#.##.##..#
#.#....# ###..###..###...##...#...##...#..#.....#...#..#.#.#..#..#..#..#...#........#..#.#...#...#.#
 #..##.##...#....##...###...#.#.#.#.###.#..#.#.#..#.#.# #..#.#.#..#..#..##..###.#.#..#.#...#..##.#.#
 #.##.#...#..#.#.##.#.....###.#..#....#.#.#...#..#.#..##..#..#...#.#..#..#.#...#...#.#..###.#....#.#
#.....#.##.#.##.....#.####.....#.#.##.#.#.#.#..#.....#...# #..##...##..#.#..##...##.#..#.....#####.#
#.#.#.#.#..#...##### #...#####.#...#....#..#.#.######..##.#.#...#.#...#..##.#..##...#.#.#.##.#.....#
#..#.#..##..##......##.#.....##.###.##.#.#...#........##.....##.#...##..#.#.#.#.#.#...#...##...###.#
 #.#...#...#.#.####.....####......#..#.#..##..##.####.#..#.#.#..#.##...#..#.##..#..###..##..#.#..#.#
 #...###.##...#....#.###...#.####..#.#...#  #.# #....#..#...#..#.#...##.#.#....# #...##.#.#..#.#.#.#
#..##.....#.#...##..#....#..#....#...###..# #..#..##..##.##.#.#..#.##......##.#.#.##..#.#..#...#...#
#.#...#.##...###..#...#.#.#...##..#.#...#..#.#.#.#..#.#.....#..#.#..##.#.#..#.......#...##..#.#..## 
#.#.##...#.##....#.#.#.#...###.##...#.#.##.#.#...##...#.##.# #.#..#...#..#.#.#.####..###..#...#.##.#
#..#...#.#.#..##....#....#...#....##..#....#.##.#.##.#..##..#..#.#.##..#.#.#.#.#..##...#.#.#.##....#
 #...##..#...#..###..#.##.#.#..##..#.# #.##....#...#..#...#..#.#.....#.#.#...#.#.#...##........##.# 
#.#.#..#.###..#....#.#..#.#...#..###..#.#.#.##.#.#..#.#.#..##..##.####.#..##.#.#...##...###.#.#.#..#
#..#..#.....##..##.#..#...###...#...#.#....#...#.##.#..# #..#.#...#....##.#..#..#.#.#.##..#.##...#.#
 #...#.#.##....#....#..#.#...###..#...#.##..##....#..#..#.#...#.#.#.###...##..#..#..#.#.#.#....#.#.#
#..##...#..##.#.##.#..#.#..#...#.#.#.#..#.#...#.#..#..#.#...#...#.#.#..#.#..#.##.#.#..#.#..#.#.#...#
 #..#.#..#.#.##.....#.#...#.##.....##..#...##.##.##..#..####.###.##.#.#..#.#...#...#.##...#.#.#.### 
  #....#........#.#.#...#.....#.##....#..#..........# #.................#....#..##......#..........#
   #### ######## # # ### ##### #  #### ## ##########   ################# #### ##  ###### ########## 
