 # # ######  # ### ########  ######## # ## ##### ### ###### ## # ####  # ### # # ##### ##### ###### 
#.#.#......##.#...#........##........#.#..#.....#...#......#..#.#....##.#...#.#.#.....#.....#......#
#.#...#.##......##..#.####....#.#.##.#...#..#.###.#..##.##...#..#.##.....#.#.....#.##..#.##.#.####.#
#..#.##...##.##...##......###.##..##.#.#.####......#....#..#...##.#.#.##.....###.#.#.#...#..#.#..#.#
 #..#..#.#...#.##...#.###....#...#.....#.....#####.#.###.#.##.#...#.#.##.##.##...#.#..###..##.#.#..#
#.#..#...#.##....##.##..#.#.#..##.#.###.##.#......#..#...#..#.#.###.#...#..#...###..#....#....#...# 
#..#.###.#.#.###..#...#....##.#....#......#.#.###..#.##.# #..#......#.#..#.#.##...#..#.#..#.##..##.#
#.##....#..#...#.#.##..#.##...#.##...#.#.#...#...#.#....##.#.#.#.###..#.#..#....#..#.#..#..#...#...#
#...#.#...#..#.#.....#..#...##..#.####.#.#.#...#.#.###.#...#....#...#.#.#.#.####.#.#..#.##.#.##..#.#
#.##.#.###..#...#.##..#...##...#..#....#.#..#.#..#....#..#..#.##..#..#..#......#...##.##...#...##..#
#..........#..#.#.#..#.#.#..#.#.#.#.#.#...#.#..#..###...#..#...#.#..#..# #.####..##....#.#..##....# 
#.###.#.###..# #..#.#...# #.#.#...#..#..#.#.##.#.#...###..#..##..##...#.##.#...#.#.#.#.#..#..####.# 
#...#..#...#..#..#..#.#..#..#...#..#..#.#.#..#..#..#...#.#..#...#..###.....#.#...#..#...#..##...#..#
#.#..#.#.#.##...#.#..#.#...#.###..#.#..#..#.#.#.#.#.##...####.##..#..#.##.##..#.#.#...##.#..#.#..#.#
 #.#.#.#.#...#.#...#....#.#......##..#..#.#...#...#...###.....#..#..#...#...#.##...#.#.....#..#.#..#
#..#.#...#.#..#..#.#.#.#..#.#####...#..#...##..#.#..#.....####.#...#..##.#.##...##....#.##.#.#...#.#
#.##..#.#.#.#..#.#.#..#..#..#.....#.#.#..#.##.#.#..#.##.##.......#.#.#...#...##..#.#.#..#..#.#.#...#
#...#..#.....#..#...#...##.#..#.#..#..#.#.#...#..#.#...#...#.##.#..#.#.#..#.##.#..#..##.##.#..#.### 
#.#..#.#.#.#..#..##..##.#..#.# #.##..#..#...##.#.....#..###...#.#.#..#..#.#.....#..#..#...#..#.....#
#.##.#..#.#.#..#...#....#.#...#...#.#.#.#.#.#...##.#.#.#...#.#..#.#.#..#...#.##.#.#.#..##.#.#..###.#
#..#...#......#.#.##.####.#.##..#...#...#..#..#...##.#.#.#..##.##.#..#.#.##....#..#..#.#..#...#....#
#.#.###..#.##...#...#.....#.#..#.#.#..#..#.#.#.##.#..#.#.#.#...#...#.#.#..#.#.#..#.#...##..##..###.#
#...#...#.#.#.#.#.#...#.##...#...###.#.#.#...#.#..#.#..#.#.#.#.#.##..#..#.#..##.##...#...#....#...# 
 ##...##.....##..#.###.##.##.###....#..#..###....#...#...#.#..#..#..# #..# #....#..#..#.##.#.##.#..#
#..#.#...#.#...#.#...#.....#....###.#.#..#..#.###.#.#.##.#..#..#..#..#.#..#.##.#.##.#.#.#...#....#.#
#.#.#.#.# #.##...###..##.#.#.##...#....##..#..#.#...#...#..#..#..#..#...#.....#.....#.#..####.##.#.#
#.....#..#...####...#....#..#...#..#.#....#.#.#...##..#.#.#.#.#.#..#..##..#.#..#.#.#...#.......##..#
 #.##.#.#..#......#.##.##.#.###.##..#.##.#..#..#.#..#..#..#...#.#.##.#...#...#.#.#.#.#..##.####...# 
#....#..#.#.#.#.###....##.#....#...#......#..#.#...#.#.#.#..#..#..#..#.##..#.#.#.#..#.#...#...#.#..#
 #.#.#.#..#..# #...##.#....###.#.##..##.#...##.#.#.....#..#.##.#.#..#...#.#.#....##.#.#.#..##.#..#.#
#..#.#...# #..#..#.#.#..###..#.#...#.#...###....#.##.#.##.#..#...##.#.#.#.#...###.#.#....#.....#..# 
#.#.#..#..# #...#......#....##..##.#..###....###....#...#..##..##.#....#..##.#....#.#.### ##### #..#
#....##.#..# ###..##.###.#.#..#....##...#.###....##..##..#...#..#...##..#...#..#.#..##...#.....#.#.#
#.##....##..#...#...#....#.#.#.###...##.#.#..#.#.#.#.#.##..#..#..#.#..#.###.#.#...#..#.#...###...#.#
#...#.##...##.#..##.#.#.##.....#..#.#...#.##....#..#.#...#.#.#.#.##..##...#..# #.##.#..##.##..#.#..#
#.#.#.##.##...##..#....##.##.#..#....#.##...#.#.#.##.#.#.##..#.#....##..#..#..#.....#.#.##...##...# 
#.#.#....#..##..#.#.##....#..###..####...##..##.#.#..#.#....#...###...#..#..#..#.###..#....#.#.##..#
 #..#.###.#.#.#.#.##..###.#.#....##....#..#.#...#...#..###.#..#...###..#.#.# #.#.#..#.#.#.##.#...#.#
#..#.#....#...#.#....#....#...####..### #.#...##..##.#....#..# ###...#..#...##.#.##.#..#..#..##.##.#
#.#....#.#.##.#..###..#.#..###.....##..#..##.#...#...#.##..#..#....#...#..##...#.....#..#..#....#..#
#..#####....#..#....#..# #.#..#.###...##.#..#.#.#..#.#..##..#...#.#.###..#.#.##.#.##.##..#..#.#.#.# 
 #.......#.#..#..##..#..#....##.#...##....#...#.##.#..#...#.#.##.##....###...#...#.#...#..#..#.#...#
#.######..#..#.#.#..#.#..###.#..##.#...###..###....##..###..#.#.....#.#....##.#.#...##...#.#...#.#.#
#.#....##.#.##....#....#...#.#.#...#.#.#...#...##.#.##...#.#...##.###...###.....#.#...###....###..# 
#...##..#.#...#.##..##..##.##..#.#.#..#..##..#...#...###...#.#..#....###..#.#.#.#.##.#...#.#....#..#
#.##.##.#..##..##..#..#.......# #...#.#.# #.#..#..##....#.#.#.#.#.##.#...#...#..#..#...##..#.##.##.#
#.#....# #.#.#...#.#.#.##.####.#..###.#..#..#.#.#...##.#.#....#.###..#.#...#..#..#.###....#.#.#....#
#.#.##..#..#..##.#.#.#...#...#..#.......##.##....##.......##.##.....##..###.#..#.#....####.....#### 
#.#.#.#.#.#.#..#.#...#.#...#..#...#.##.##..#.###.#.#.##.#..#...#####..#.#...#.##..###.#....##.#....#
#.#.#.#.#.....#..###.#..### #..#.#.#..#...#....#...##....#..#.#.....#.....#.#.#..#....#.##...#..##.#
#.#...#..###.# #...##.#.#..# #..#...#.#.##.#.#.###...#.#.##.....###.##.##..#..#.#.#.##...###...##..#
#.##.# #...#..#.##....#..#..#.#...#...#.#.....#...##.#.#..###.###.....#..#.#.#....#..#.#....####..# 
#.....#..#.#.#....#.#..#..#....###.##.#..##.##..#.#..#..##...#...##.#..#...#..##.#..#...#.##.....#.#
#.###.#.#..#.#.##..# #..#.##.###.#..#..#.#.....##.#.#..#...#...#...#..#..#.##..#.#.#..#..#...#.#...#
#...##..#.##...# #..#.#.#..#.......#..#...#####...#.####.## ### ##..#..##....#.#.#..#.#.#..##.#.##.#
 #.#...##.#.###.#..#.....#.#.#.##.#..#.##......#.##......#.#...#..#..#...###.#..# #.#..#..#.....#..#
  ##.##.......#...#..##.#...##.#..#.#....#####.#...#####.#...#...# #..##...##.#.# #..#.#.# ##.#..#.#
 #...#..##.#.##.##.#..###.#.#..##.#.#.##.....#.#.##.....#..#.#.#..#..#.###....#..#.#.#.#..#....##..#
#..#..###...#...##.#.#....#.#.#...#.#..#.##.#..#....###..###.#.#.#..#......##..#...#.#.#.#..#.#...# 
#.##.#...##.#.##...#...###....###.#...#..#..#.##.###...#....##.#.#.#..#.###..#...##..#.#.#.#.#..##  
#...#..#..#.#.# #.#.#.#...##.#...#..##..##.##.#..#...#..#.#....##..#.#.#...#...##...#.#..#.....#..# 
 ##..#..#.#.#..#....#.#.#...#..#..#...#...#...#.#..##..#...#.##...##.#.#.#.#.##...##...#.#.#.#..#..#
#...#.#.#..#.#...##..#..#.#.##..#..###.##.#.##.#..#...#..#.#..#.##.....#.#..#.#.## #.#.#..#...##.#.#
#.##..#..#...####..#..#..#.....#.#........#..#...#.#.#..##..#.#...#.##.#..#.....#.#..#.#.#..#......#
#.#..#..#.#.#...##.#.#.#..#####....#.###.#.#.##.##.#..##...##..##.##..#..# #.###....#....#.#.#.###.#
#...#..#....#.#......#..#......#.##.#...#..#....#...#.##.##..#..#...#...#.#.#....###..###.#...#....#
#.##..#..####..###.##..#..#.#.#...#.#.#...#.####..#.#....#..#..# ##...##....#.#.#....#......#..##.# 
#.#..#..#....#....#..#.#.#.#..#.#...#..#.#.......#..##### #...#.#..###..##.#..#.###.#..###.#.#...#.#
#.#.#..#..##..###...#...#....#...#.#..#..#.#.####..#.....#..##...#....#..#..#.#....#.#....#...##...#
#....#...##.#....##.#.#.#.##..####.#.#..##.#.#...###.#.#..#..###...##..#..#...#.##...#.##.#.#.#..#.#
 #.#..###....###.....#..#..###....#...#....#...#.#....#.#..#...#.##.#.#.#..#.#.##.##..#.#.#.#..#.#.#
#...##....##...#.#.#...#..#....##...#..####..#.#.#.##....#..##..#.......##...#....#.#........#..#..#
#.#...##.##..#..#.# #.##.##.####.### ##....#..#..#.# ####.#.#..##.#.##.#...##.#.#.#..###.#.#.###..# 
 #.##..#...#..##...#.#...#..#.......#...##..##..#...#.......#.#...##...#.###....#...#...#...#....#  
#...##..##..#..#.#...#.#..#.#.#####.#.## #.#...#..###.#####.#.#.##...#.#....##.# ###..#.#.#.#.##..# 
#.#...#..##..###..##...##.#...#.....#...#....##..#....#....#..#.# ###..##.#..#..#....#...#.#..#.#..#
#..#.#.#...#....#...#.#....###.#.###.##.#.###...#..#.#..##..#.#..#...##....#...#..###..#.#...#...#.#
 #..#...##.##.#.#.##.#.####....#.....##..##...#..#..#..##.#.#..#...#.##.#.#.##..#.#...#..#.## #.#..#
#..#..#..#...#..#.#........#.#.##.#.#...#...## ##..#..#...#..#..##.#....##....##...#.#.#...#.#..#.# 
 #...#..#.##.#.#..#.######...#...#..#.###.###.#...#..#.#.# #..#...#..#.#.#.##...##..#..####....#...#
  ###..#...#.#..#...#.....##.#.###.##.....#...#.#.#.##....#.#..##..#..##.#...##..##..#....#.##..#.# 
 #....# #.#..##..###..#.#..#..#......#.###.#.##..##...#.##..#.##.#.##.....##...#...#..#.#.##...##..#
#..##..##...#.#.##...#..#.#..##.####..#....#...#...##.#....#.....#...#.###.#.#..##.#.#..#...##...#.#
#.#...#...##....#..###.#...#....#...#.#.##..##..#.##..#.#.#.#.##.#.#.##.....##.#.....#.##.#...#.##.#
#..###..##...##.#.##...#.###.#.#..#.#...#.#....##.#..#..#...#..#..##..#.#.#.#..######....#.##...#..#
#.#...#...#.#....#...#..#...#.#.#.#..#.#...####...#.#.##..#.##..#...#.#..#..#.#......#.#.#....#..#.#
#.#.#..##...#.##...##.##..#.#......#.#.#.#......#.#.#....#....#.#.###...#..#..#.#.##.#.#..####..#..#
#.#.#.#..###....#.#......##..#.###.#..#..###.##..##..#### #.#.#..#...#.#.#..#....#...#..#.....###.# 
#.#.#.#.#....#.#.#..#.###...#..#..#.#...#..##...#...#....#..#..#...#..#...#..#.##..##.#..####.....# 
#.#.#.....#.# #....#.#..#.#.##..#....##..#....##..##..##..#.#.#.#.#.#...#..#.#.#..##....#....#####.#
#.#..#.#.#.#.#..###...#..#.....#.#.#.#.#..#.#...#..#.#..#.#.#....#...##..#.#..#..#...###..##.....#.#
#..#..#.#....#.#....#..#...####.....#...#..#.#.#..#....#..##..#.#..#...#.#...##.#..##..#.#..####...#
#.#..#...##.##...### #.#.##....#.##...#...#...#..#..###..#...#....#.##..#.#.#...##...#....#.#...#.# 
#..#.#.#.#....#.#...#...#...##..#..#.#..#.#.#.#.# #....#..##.#.#.#..#.#.#.##..##..##.#.##.....#.#..#
#.##...#..##.#.#.##..##.#.##..#...#...##.#..#...##..##..#.#...# #..#....#....#..#..#.#...####..#..# 
#...###.#..#.......#..#.#...#..##..###...#.#.###...#.#.##.#.#..#..#..###.#.## #..#...##.#....#.#.#.#
#.##.....#.#.##.##..#.#..##.#.##.#.#...#.#.#....###....#...# #.#.#..#......#.#.#..##...#..##..#....#
#...#.#.#...#.#.#.#.#..#..#.#.#..#.#.###....#.#.....####.#..#..#..#.####.##.....#...##.#.#..#..##.# 
#.#...#...#.....#.....# #.......#.......#.#....#.#.#......#...# #........#..#.#...#........# #.....#
 # ### ### ##### #####   ####### ####### # #### # # ###### ###   ######## ## # ### ########   ##### 
