#####################
#.....#.......#.....#
#.###.#####.#.###.#.#
#.#.....#.........#.#
#.###.#.###.#.###.###
#...#.........#.....#
#.#.###.#.#.#.###.#.#
#...............#...#
###.###.#.#.#.###.#.#
#.#.#.........#.....#
#.#.###.###.#.###.#.#
#.........#.....#.#.#
#.#.#.#.###.#.#####.#
#.#.....#.....#.#...#
#.###.#.###.#####.#.#
#...#.........#.#.#.#
#.###.#.###.###.#####
#.#.....#...........#
#.#.#.#.###.###.#.###
#...#.....#.#.....#.#
#.###.#.#.#####.#.#.#
#...#.......#.#.....#
#.#####.#.###.###.###
#.#...#.#.#.....#...#
#.#.#.#######.#.#.###
#.......#.#.#.......#
#.#.#####.#.#.#.#.#.#
#.#.#.#.......#.#...#
###.#####.#.###.###.#
#.....#.....#.....#.#
#.#.#####.###.#.###.#
#...#.#...#.........#
###.#.#######.#.###.#
#...........#.#.....#
###.#.#######.###.###
#.....#.#.......#...#
###.#########.#.#.#.#
#.....#.#...#.#.#.#.#
###.###.#.#########.#
#...............#...#
#####################
