#########            
#...#...#             
#.###.######          
#..........#            
#.#####.##.#            
#.#...#.##.#            
#.#.#.#.##.#            
#.#.#.#.##.#            
#.#.#.#.##.#            
#.#.#.#.##.#            
#.#.#.#.##.#            
#.#.#.#.##.#            
#.#.###.##.#           
###.....##.#          
  ##########          
           

                       
