 #  ## ###### ## # #### ####### ## # # ###### ######## #### #### ###  ##### ## ### ##### ## ####### 
#.##..#......#..#.#....#.......#..#.#.#......#........#....#....#...##.....#..#...#.....#..#.......#
#....#..####..#....#.#.#.#####..#.....#.##.#.######.#.#.##...##...#...#.##..#.#.#...#.#...#..#.###.#
 ###.#.#....#.#.##.###...#....#..#.#.#..#..#......#.###...##...###.##.#...#.#...##.#.#.##...#.#..#.#
#..#.#..#.###...#.....####.##..#....#..#..#.#####.#....##.#.##.#.#..#..##.#..###...#.....###....##.#
 #.#...##....###..###......#..#..##...#.#.#.#.....#.##..#....#.#...#.#..#..#.....##..###...#.##....#
#...####..##.#..##...##.#.#..#.###.###....#..#.#.#..#..#.###.#..#.#...#..#.#.#####..#..#.#.#...#### 
#.#.#....#.#...#...#...#.#.#.#........#.##.#....#..#..#..#...#.#....#..#.#.##.....#..#....#.##.#...#
#.#.#.#.#...#.##.##.##.....#..#.##.##.#.#....###..# #...#..##..#.#.#..#..#....###..#..#.#...##...#.#
#..#...##.#.#....#.....###.##.#...#.....#.###....#.#.##...#...#..#.#.#.#..#.#...##..#..#.##...##.#.#
 #...##...#..#.#.#.#.##.....#.#.#..#.###..#...#.##...#.###.#.#.#..#.....#..# ##..#.#.#.....#.#..#..#
#..###..##.#..#..#..#...#.##..#..#..#...#..###....##...#.....#..#.#.####.#..#..#.#...####.##..#...# 
 ##....# #..#.#.#.#.#.##.#.#.# #.##..##..#....###...##.#.#.##..#...#......#..#...###....#...##..##.#
#...###.#..#...#....#......#..#....#...#..###.#...#....#..#...#..#.#.##.##..#..##..##.#.###.##.#...#
#.##..#...#..##..##..#.###..#.####..##..#...#.#.#.##.##.#.#.#...##....#..#.#..#..#...##...#.....#.# 
#...#...###.#...#..#..#...#.#....##..##.###.#..##...#......#.#.##..###..##.#.#..##.#...##..##.#.#..#
#.#..#.#.....#.#..# #.#.#..#.#.#...#..#...#..#.#..##..#####...#...#....#...#.##....###...#...#...#.#
#.#.#....#.#....#..##.#..#...##.##..#..##.#.#..#.#...#......#.#.##..##.#.###..#.###....#..##.#.#...#
#.#..##.#.##.###.#....##..##......#..##...#.#.#..#.##.####.#...#...##.#..#..#.#.#...#.#.#..#..#.##.#
#.##...#....#....#.##...#...##.##..#.#..##..#.#.#...#......#.#.#.###..#.#.#.#..#..##.#..#.#.#.#....#
#...##.#.##...#.#....###.#.#...#.#.#...#...#..##..##..#####.#..#.....##.#....#.##.#....##.#.#..##.# 
 #.#.....# ####..##.#.......#.#....##.#..#.#.#...#...#....#...##.#.#.#...#.##.....#.#.#......#...#.#
 #..#.###.#....#...#..#.####..#.#.#..#.#.#.#..#.#..##..##.#.###..#.#..##.#...####.#.#...####..##.#.#
#.#..#....#.#.# ##...#.#...#.#..#...#....#..#.#..#..#.#...#....##..#.#...#.#.....#...###...### #...#
#..#..##.##.#..#.##.#...#.##..#..###..##..##...#..#.#..#.#.###.#..#..#.##...##.##..##....#....#..#.#
#.# #.#.....##.....#..#...#..#..#....#  #....##..#..##..#....#.##.#.#..#..##.#...#..#.#.#.###..#.#.#
#..#..##.##..#####..#..##.#.#..#..###.##.#####..#.#...#...#.#......##.# #.#...##..#.#..#.....#..##.#
 #.#.#...#..#.....#..#..#.#..#..#...#....#.....#..###.#.##..#.#.###...##....#.#..##..#.#.##.#.#....#
#..#.#.##..#..###.##...#...#..#..##.##.#..#.###.#.....#...#....#....##...###..#.#..#.#...##....#.#.#
 #.#.#.#..#.#.#.....##..###.#..#..#....#.#..#...#.#.#..####.###..#.#...##...##..#.#..####..###..##.#
#.....#..#.....#.##..##......#.#.#.#.##...#.#.#.#.#..##....#....#.#..#..#.#..#.#....#....#....#.#..#
#.##.#..#.##.#.##..#...#.##.#...#...#...##..#.#....#..#.##.#.#.#....#..##.#.#..#.#.# #.#.#.#.##..#.#
#...#..##...##...#..##..#...#.#.#.#...###..#.#..##..#....#.#..#..###.##...#.#.#...#.#..#..##...#.#.#
 ##..##...#...##..#...#.#.#..#..#..#.##...#...##..#.#####...#.###.......##..#...#.#...#.#....##..#.#
#..#.#..##.##...#...#.#...##.#.#..#.#...###.#....# #......###.....##.###..#..####..#.#...#.##.#.##.#
#.#....# #...##..###..####...#..#.#...##....##.#..##.#.#.#...#####..#....#..#....#....##..#.....#..#
#..####.#..#..##...#.#...#.##..##...##...###....#....#..#..#......#...#.#..#..##..###...#.#.##.#.#.#
 #....#...#.#..#.#.#...#.#.#..#..###...##..#.##..####.##..#.####.#.#.##.#.#..#...#...##.#.#...#....#
#.##.##.##...#..#...###...#..#.#.....##..#.....##......#.#.....#...#...##.#.##.##..#..#.#..##..###.#
#....#..#..##.#...#.....#.#.##.#.##.#..#...##.#...####...##.###.##...#....#.#..#..#.#.#...##.#....# 
 #.###.#..#...#.#.####.#..#....#..#..#.#.##..#..##....###.#.....# #.#.####...#.#.#..#.#.#.....#.#..#
#..#...#.##.#.#..#...#.#.#..#.#..#..#..#..#.#..#...##.......#.#..#.#..#...#.#....##...##.#####.#.#.#
#.##.##..#..#.##.#.#..#..#.##.#.#..#.#...#..#.#..#..##.#####.# #.....##.#....####...##...........#.#
#.#..#.#.#.#...#.#..#..##..#..#..#.#..#.#..#..#.#.#...#.......#..##.#....###.#....##...#.#######.#.#
#.#.##.#.#..##.##.#..#...#.#.##.#..##.....#..# #...#.#..#.###..#..#...##...#.#.###...##.#......#.#.#
#...#.....#.#.....#.#..#.#..#...#.#...####..# #..#..#..#.#...#..#..###..###..#.#...#..#...##.##..#.#
#.##..#.#.#.#.#.#...#.#..##.#.#.#..#.#.....#.#..#.#.##.#...#...#.#.....#...#.#..#.#.#.#.##.#..#.#..#
#...#.#..#..#..#.### #..#.#...##.#..#..####....#..#..#..#.#.###...#.#.#..#....#.#.#....##...#.#.#.# 
 ##...##.#.#..#.....#..#..#.##...#.##.##...##.#.#..#...#....#...#..#..#.# #.##..#..###....#.#.....# 
#.###..#.#..#.#.#.#..#..#...#..###.#..#..#.#.....#..###.###..##..#...##..#.#...#.##...##.##..####..#
#....#..#.#..#...#.#..#..#.#.#.#...#.##.#..#.###.#.#..#....#.#..# ###..#.#..#.#.....#.#....#....##.#
#.#.#.#.#..#.#.#...#.# #.#...#.#.#.#.#..##..##...#...#..#.##..#..#....#..##...###.##..####..###...# 
#.#...#..#.#...####..# #..##.#.#.#.#...#...#...##.#.#..#....#..#...#.#..#.#.##....#..#...##.#..##..#
 #..##..#...###.....#.#.#.#....#.#.####.#.##.##.....#.#..##.##..#.#..#.#..#.#.#.##..#..#..#...##..# 
#..#.#.#..#.#...#.###...#..#.##..#....#...#..#.#.#.#..#.# #..#.#.#..#..##.#...#.#.#..#..#..##.#..#.#
#.##.#..##..#.##.#....#..#.##...#.##.#..##..#....#.#.#...#..#..#...#..#....##...#..#.##..#...##.#..#
#....##..#.##..#...###.#....#.##..#...#....#..##.#.#..#.#..#..##.#..#..#.##..###..##..##..##.#...#.#
 #.#..##.....#.#.#.#...####.#..##...#..####..#.##...#.#.#.#.#...#..#.#.#....#....##.#..#.#.#...#.#.#
#..##...####.#..#..##.#...#..#...#.##.#...##.#....###.#.##...##..##....#.#.#.#.##....#...#..#.#..#.#
 #...##.#..#.##..#..#.#.#..#.###..#...#.#....#.#.#....#....#.# #..#.#.#..#...#....##..###..# #..##.#
#..#.#....##...#.##...#.##.#....#.#.##..####.#..#..###.##.#...#.#...##..##.#.#.#.#.#.#....# #..#...#
#.##.#.#.#...#.#..###.#..#..###...#..##....#..#..#......#..#.#...#.#...#...#..#..#....#.#..#..##.#.#
 #...##...#.#.# #...##..#.#.#.#### #...###..#.##..###.#.##.#...#..##.##.#.#.#...#..##...#.#..#...#.#
#..##...##..#..#.##....##.#.#.....##.#....#.#...#...#..#...##.#.#...#...#.#...#.#.#..###...#..#.#..#
 #..####.#.#.#.....####...#..####....####.#.###..#.#..#..#..##...##...#...#####..#.#.....#..#.#..#.#
#.#........#.#.##.##....#..#....#.###...#..#....#.#..#.#..##...#...###..##.....##...#.##..#.#..#.#.#
#...###.###..#.#..#..###.#..###..#....#.#.#..#.#...#.#.#.#...## ##....##...###....#.#...#..#.#.#.#.#
#.##...#...#....#...#.....#...##.#.####.#.##.#.#.#...#.#.#.##..#..###....##...####...##..#...#.#.#.#
#.#..###.#..#.##.#.#..#.#.###..#...#....#..#.###.####..#....##...##..####..#.##...##..##..#.#..#..# 
#.##.#...##.#.#..#.##..#.#....#.###..#.#.#.#.........#.##.#..#.#...#.....#...#..#.#.#...#..##.#.#..#
#..#...##.#...#.##...#.....#.##....#.##..#..######.#.#...#.##..###...###..##.#.##.#.##.#..#...#...# 
 #..#.#....##.#...##.##.###..#..#.##...#.##.......#..##.#.....#..##.##..#.#..#.#..#....#.#..##..#..#
#.#.#.#.##.#.#..##.#...#...#.#.#....##.#..#######.#.#...#.#.##.#...#...#....##.#.# #.#.#..#..##.### 
#...#.#.#......##...##...#.#..# ##.##..##.......#.#..#.##.#.#..#.#..#.##.#.#...#..##..#..#.#..#....#
#.#.#.#..##.#.##..#...#.#...#..#...#..#.#.#.#.#.#..#.#....#..#.#..#...#...#..#..#...#..#....#.#.##.#
#.##...#.#...#...# ##.#..#.#..#..##..#...#..###..#.#..#.##.#.#...#.##..#.#..#.##..#..#..#.##..#.##.#
#...##...#.#.#.##.#.#..#.#..#...##..##.#..##....#..##..#.....#.##...##.#.#.##....#.#...#.#...#.#...#
 ##..##.#.#..#..#....#.## #..###...#....#....#.#..#...##.####..#.##..#...#...###....#.##...##....#.#
#..#...#...## #.#.#.#....#.#...#.##..##.#####.##.#..##...#....#....#..#.#.##....####.#...##...##..# 
#.#.##.#.#...##..#...#.#.#.#.#.#...#...#.........#.#..#.#..#.#..##.##..#....#.#......#.###..#...#..#
#...#..#..##....#..#..#..#.#.#..##.#.#...#.##.####..#...##..#..##...#.#..##.#..#.#.#.#.#...# ##.##.#
 #.#..#..#..##.#..#.##..##...##.#..#.####....#....#..##...#..#.#..#....#..#.###.#.#..#..#.# #.#..#.#
#..#.#..#..#  #..##....#...##...#.#.#....###..#.#.##...##..#...#.# #.#.##.#.........##.#..##...#.#.#
#.##.##..#..##..#...### #.#.#.#.#.....##...#.#..#...##....#.###.#  #..#...####.###.#...##....##..#.#
#.#....#..#....#..###..#....#.## ######..#.#...#.##.#..####......##..##.##....#...#..##..###..#.#..#
#..#.#..#..#.#.#.#....##.##.#...#......###..###..##.#.#....#.###...##...#..##...#..#...#.....#..#.# 
 #..#..#..#..#.#.#.#.#...#.##.#.#.##.#.....#....#...##..##...#..##....#..#.#.###..#.##..###.#..##..#
  #...#.#.#.#..#.##..#.##....#..#...#..##.#..##...##...##.###.#...###.#.#..#....#....#.#...# #.#.#.#
 #..##....#.#.##...#...#..##.#.#.##.###....#...#.#...#.#..#.#.#.#....#..#.#..##..#.###...#..#..#...#
#..#...###..#...##..##.#.#.#.#...##....###..###..##.#..#.#....#..###..#.#.#.#..#.#....##..#.#.#.##.#
 #...##....# ###..#...#..#...###...#.#...###...#...#..#....##.#.#...#...#...##.#..###...##..#.#....#
#.###..#.#..#....#.##...#.##....##..#..#...#.#..##.#.#..#.#.#...#.#.#.#.##.#....#.#.###....#..#.#.# 
#...#.#...#.#.##...# #.#....###.# #..##.##...##.##...#.#.....#.#..#..#....#..#.#..#...#####..#.#..# 
#.##...##.#...#..#..# #..##.#....# #.....####.#...###...##.###.#.# #..####..#...#..#.#......#..#.#.#
#.#..#..#..#.#.#..#..#..#...#.##..#..#.##.....###...###..##...##..#.#.....#.#.#.#.#....##.##..#..#.#
#.#.#.#..#..#...#.##.#.#..##....#..#.#....#.#....##....#..#.#...#....####.#.#.#.#..####...#..#..#..#
#.#.#..#..#.#.#.#...##.##...#.#..#..#.#.##..#.#.#..###..###.#.#..#.##...#...#..# #.#...##.#.# #...# 
#.#...#.#.#.##...#.#....###....##.#....#...#.#...#...##.#....#.#......#..###.#..#....#.#..#.##..#..#
#...#...#......#.#...##....#.#.....#.#...##....#...#..#...##....#.#.#..#......#...#.#....#.....# #.#
 ### ### ###### # ###  #### # ##### # ###  #### ### ## ###  #### # # ## ###### ### # #### #####   # 
