#########   ########
#.......#####......#
#.......|...|......#
#.......#####......#
#########   ########