 ##### ### ## ##### ###### ########### ### #### ## ### ##### ######  ### ### # ###   ###   ####   # 
#.....#...#..#.....#......#...........#...#....#..#...#.....#......##...#...#.#...# #...# #....# #.#
 ##.#.#.#..#...#.#.##.#.#...###.###.#.#.#.#.##..#...#..#.##.#.##.##...#.#.#.....#..#..#..#..##..#..#
#..##.#.##.#.#.#.#...##..#.#....#..#..#..#....#..#.#.#....##..##....##..#.#.##.#.#.#.#.#...#  #...# 
 #....#...#...#..#.#...#..#..###.#..#...#..#.#.#.#....#.#..#.#..####..#...#...#..#..#....##.#  ##..#
#..#.#.#.#..#..#..#.##.#.##.#....##.##.#..#.#..#..#.#.#..#.#..#......#.#.#.##..#...#..####...##..#.#
#.#..#...#.# ##.#.#.....#...####........#.#...#..#.##..#.#..#.##.#.#....#...#.#..##..##....#....#..#
 #..#.#.#...#.....#.#.#...##....#.#.####..##.#..##...#.#.##.#...##.#.#.#..#.#.#.#..#.#..###.##.# #.#
#..#......#.#.#.#..#.#.#.#.#.##..#..#....#....#.#..#...#..#.###...##.#..#.#.#.#..#....#...#.#...#..#
#.##.####.#.#..#..#.....#.....#.#..#..###..##.#...#.###.#..#...##....##.##..#..#.#.##..##.#..#.#..# 
#.#..#...#...#..#.#.#.###.#.##..#.#..##...# #..###......##.#.#...####.#....#.#.#.#..#.#.#..#.#.##..#
#.#.##.#.#### #.#.#.#.#...##.#.#.#..##..#..#.#.#..#.#.#..#.#..##.......#.#.#.#.#.#.#..#..#...#...#.#
#.#.#..#.....#..##..#...##...#...#.#...##.#..#...#...#.#.#.##.#.##.##.#..#.#.#.#..##.#.#...#.###.#.#
#..#..#.##.#.##....#.##.#..#..##.#..#.#...#.#.#.#..#...#.#....#..#.#...##..#.#..#....#.#.## #....#.#
#.#..##...##...#.##....#..#.#..#..#.#.#.###...#..#.#.#.#..####..##..###...#..##..##.#......#..###..#
#...#...#...#.#..#..#.#..#...#.#.#...#..#...#..#..#..#..#......#..#.#...## #...#.#.#.#.###..#.....# 
 ###.#.#..##..##...#..#.#.#.#..#..##...#..#..#.##.#.#.#..###.#...#..#.###.#.##.#......#..##.##.#.#.#
#....#.#.#...#..###.#...#...#.#.#...###..#.##.#...##..#.#....#.##..##.#........####.#..#......#.#..#
#.##.#..#..## #...#..#.#.##.#.#...#...#.##....#.##...##..#.#..#...#.....#.####.....#..#.##.#.#...#.#
#.#...#.#.#..#..#..#.##...#.#..#.#..##.....#.#..#.#.#..#.#.#.#..#.#.###..#....#.#.#..#....#....#...#
#.#.#...#.##..#..#......#....#..#..#...#.#.#.#.##.....#..#.#.#.#.#..#..#.#.#.#...#..##.##..####.##.#
#..#.##.#...#.##..#.##.#.###..#.#.#..#..# ##.#.#..##.#..#..#.#.#...#..#.#..#..###..#....##....#..#.#
 #.#..#..##.#...#..#..#......##.#.#.#.#..#...#..#..#...#.#.#.#...###.##.#.# #.#...#..##...#.#..#...#
#...#..#..#.#.#..#.##..#.#.#.#..#..#..#.#..#.##.###..###.#..#..##.......#..#..#.##..#..###.# #..#.# 
#.#.##.#.#...#..##...#.#.##.#..# #...#..#.##..#....#......#.#.#...#.##.#..#..#..#..#..#.....#.#.#..#
#.#..#...#.#.#.##.##...#......#.#.##.#.#..#.#..###..#.#.#.#..#..## #...#.#..# #.#.#.#...###.#...##.#
#..#..#.#..##.......#.#.#.####....##.#.#.##...#...#.#..#.# #...#..#..##..#.#.#....#...###.#.#.#...# 
 #..#..##.#...###.#.#.#..##....#.#...#.#...##...##..#.#...#..##.#...#...#.....##.#..##....#.##..#..#
  #..#.....#.##....##..#....#.#..#.##...##...##.#..#.##.#..#....####..##..###...#.#.#.#.#.#...#.##.#
 #.#..#####..#..#.#...#..#.#.#.#.#...##.#.##..#.#.#......#..#.#.....#..#.#...##...#.#...#..##..#...#
#...#.#....#..#.##..##..#..#....#.##....#.#.#..##..#.#.#..#..#.##.#..#.##..#...##...#.## #...#.#.#.#
#.##..#.##..#.#..#.#...#..#..##...#.##.##....#.#.#.#.#..## #.#...#..#....#.###..##.#....#..##..#..# 
#.#..#....#....#.#..#.#..#..#..##...#.#...#.#....#.#.##...##...#...# #.#..#...#..#..###..#..#.# #..#
#...##.#.#.##.#...#.##..#..#.#..#.#.#...#.##..##.#.#...##...##..#.#.#...#...#..#...#...#..#.#.# #.# 
#.##...#.#.#.#..#.#...#...#....##.#.#.#.#..#.#.##..###.#..#...#..#...##.##.#.#..#.#..#.##.#.#..#...#
#.#..##..#.....#.#.##..#.##.#.#...#.#.#.##.#.#....#.....#..#.##.#..#..#...#...#.#..#.#..#.##.#...#.#
#.#.#.#.#..####....#.#.#....#.#.###..#....#..#.#.#..#.#..#.#.#...#.##..#.#..#...#.#...#.#.....###..#
#.#.#.#..#.#....##...#.#.#.#.#..#..#..#.#..#...##.#..#.#..#...##.#...#..##.#.##..#..##..#.#.#...#.# 
#.#...##.#..###.#.#.#..#..#....#.#..#..#.#..#.#....#....#..##..##.##.##....#....##.#.#.#.#...####..#
#..##..#.##.....#...#.#..#..###....#.#.#..#..#.#.##.##.#.#..##....##...##.#.##.#...#...#...##....#.#
 #..####...#.####.#.#..#.#.#....##...#..#...#..#....#.....#...#.#...##...#....##.##.#.#.#.#.#.##.#.#
#.#.....#.#.#....#..##..#..#.#.#...#.##...##..#..#.#..#.##.##.#.##.#.###...##....##.#.#...#...##...#
#..##.#.#...#.##.#.#..#..#..#.##.###...##.#..#..#...#..#....#.#..#.#...#####.####...#..#.##.##..### 
 #...#..#.#.#.#..#...#..#.#.#....#..#.#.#...#..#.##...#..##.## #.#.#.#.......#....#..#.#....#..#...#
#..#...#.#.....#..#.##.#....##.##.#.#....##..#.#...###..#.#...#..#.#..##.###.#.###.#.#.#.###..#.##.#
#.#.###...#.#.#..#.#.....###......#..#.#.#.#..#..#.#...#...##.#.##..#..#.#.#.#...#...#.#...#.#.....#
#.#.....#..##.#.#....##.#...#.#.#..#....#....#..#....##.#.#...#.#..#.#.#.#...#.#..#.#..#.#.#.#.#.#.#
#..##.##.#.#..#...#.#.#.#.#.#..#..##.#.#..#.#.#..###..#.....##...#.#.#.#.#.##..##..#..#.##.#.#.#.#.#
 #....#..#.#.#.###.#...#..#.##.#.#...##..##...##.#..##..#####.##.#....#..#.# ##...##.#.....#...#.## 
#.####..##..#........#.#.##...#...#.#...#...#.....#....#.......#..###..#.#..#...#.#..#.#.#.#.#.#...#
#.#....#..#..##.#.####...#.##.#.#.#.#.##.###.#.##.#.###..##.##.#.#..#.#..##...###.#.#.#...#...# ##.#
#...##...#.#..#..#....#.#...#.#.#..#..#.......#..#....#.#.#.#..#..#.#.#.#...#.#...#.#.#.##..#..#...#
#.###.#.#..##.##..#.#..##.###.#..#...#..##.##.#.#..#.#....#.#.#.#.#.#.#.#.##.#..##..#...#..#.##..#.#
 ##......#..#....#...#....#...#.#.###.#.#.#...#...#.#..#.#..#.#...#.#.#..#....##...#..###.#....#.#.#
#...##.#.##..##.#..#..#.#.#.###...#...#.#...## #.#..#.#.#..#..#.#.#....#.#.##.#..##..#....#.##...#.#
#.#.#.#...##..#.#.# #..#..#.#...##..#...#.##..#...#...#...#.#.#.#..#.#...#..#..#...#.###.#..#.####.#
#..#...##...#..#...#.#..#.#.#.##...#.####..##.#.##..###.##..#.#.##.#.#.#.#.#.#..##.#....#..#..#....#
 #...#.#.#.# #...#....#.#.#..##..##......#..#...#..#....# #....#...##...#..#..#.#..#.##.#.# #...### 
#.###..#.#..#.##..#####..#..#...#.#.#.##.##..#.#..#..##..# ###...##...#..#..#.....# #...#..#..###..#
#.....#..##.#...##.....#..#...###..#.#.....#.#.#.#.#...#..#...##..#.##.#..#.######.#..##.#..#.#...# 
 #.#.# #....#.#..#.###...#.###...#....###.#..#..##...#.##.#.#...#..#....###......#...#...##.#.##.#.#
#..#..#.#.#...#.#..#..##.#.#...#..#.#.#...##..#...#.##...#..###..#.#.##....###.#..#.#..#....#..#...#
 #.#.#...# #.##...# #......#.#..#...#...#...#.#.#..#...#.##....#.#.#..##.#....# #.#..#.#.#.##.#..#.#
#..#.#.#..#.#..###  #.#.###..#.#.###.###.#.##..# #..#.#....#.#.#..# #...#.###..#..##.#..#..#...#.#.#
#.#.##..#.#..#....##...#....##.#.........#...#.# #.#...##.#.#...#..#.#.#.....#.#.#...#.#..# #.#..#.#
#.....#.#..#...#.#...#.#.#.#...#.#.#.#.#.###.#..#..#.#..#.#...###.#..#.#.#.###.#..##..#..#.#..##.#.#
#.#.#.#.##..#.# #..##.#..##.#.##.##.#..#...#..#.#.#...#.#...##......#..#..#....##.#.#..#.#..#...#..#
#..#..#..##.#..#..##...#....#...#....#..#.# #.#.#..##.##.#.##..#.#.#..#.#...###...#..#...##..##.#.# 
 #.#.# #..#.##...#...#..###..##.#.##.##.#.##..#.##...#....#...##.##..#....##....#.#.#.###.##..#...# 
#..#..#..#....##..##.##....#..#....#..#.#....##...##...##..#.##...#.#.#.#.#..###..#.....#...#..##..#
#.#..#..#.#.#.#.#.#....###..#..#### #..#.#.#...##...###..#...#..#.#.#..#..#.##...#..#.#.#.#...#..#.#
#.#.#.#.#..#..#...#.#.#....#.#.#...##.#...#..#...##....#..###.#.#.#..#..#..#...##..#.##.#..#.##.#..#
 ##...#.##..#..#.##..##.#.#....#.#....#.#.##..#.#..###.#.#....#..# #..#...#..##...#.....##.#....#.# 
#...##....#..#.#.#..#...##..####..##.#..#...##..##...#.#..#.##.#..#..#..##.#.#.#.#.##.#...#.#.#.#..#
#.##...#.#..#..#..##..##...#....#.# #..#.##.#..#.###.#..#........#..#..##....#...#...#..#.....##..# 
#.#..#..#..#..#.#....##..###.##.#..#..#.....#.##.....#.##.#.#.###..##.#...#.#.#.#..#..##.##.##...#.#
#...#.##..#.#.#..####...#....#...#...#.##.###...##.#.#...##..#...#.#..#.##..#...#.# #.#....#...##..#
#.##.....#..#..#......#..##.# ### ###...#.#..##.#...#.##.#..#..#...#.#..#..#.#.#...#..#.#.#..##...# 
#.##.#.#...#.#..#.#.##.##....#...#....#.#.#.#...##.#..#..#.#..#.#.#..##..#...#..#.#..#..#...#...#..#
#...#..#.#....#.#.#.#.....#.##.#...###..#.#.#.##.....#..#...#.#..#..#..#..##.#.##..#..#..#.#.#.#..# 
#.#...#...####..#..#..##.#.#...###.#...##.#.#.#..#.#..#..###...#.#.#..##.#...#...#..#..#..#..#.#.#.#
 #.####.##...#.#.#.#.#.......##...#..##...#.#...#.#..#..#...##.#...#.#...#.##..##.#.#.#.#..#...#...#
#......#...#.#.#.#..#.#######...#...#...##...#.#...##..#..#..#.#.###..##.#.#.#......#...##...##..#.#
#.##.#.#.###.#....#...........##.##..#.##..#...#.#....#..#.#...#....#....#.#.#.###.#..#...###..#..# 
#.##.#.#.#....#.#.###.########....#.#..#..#.###..#.#.#..#...###.###..#.##..#.#....#..#..##....#.#..#
#...#.....###..#.....#.......#.##.#..#..#.#.....#.#.#.#.#.##....#..#.#...#.#.#.#.#..#.##...##....#.#
#.#.##.#.#...#..###.##.#####...#..##..#..##.####......#.#....##.#.#..#.#.#.#....#..#.....#.#..#.#..#
#.#...#..#.#..#.....#..#...###..##...#.#.#..#....####.#.###.##.....#..#..#..#.#..#...#.##..#.#..#.# 
#..##.####.##..#####..#..#...##.#..##....#.##.#.##..#.#...#...####.##..##.#..# #.####...#.# #..##..#
#.#.#........#.#.....# #..##..#...#...##.#...#..#..##.#.#.#.#.#..#...#.....#..#.#....##.#..#..##.#.#
#.#..###.####..#.####.#.#...#..##.#.##.#..##...#..#...#.#..##.#.# ##..###.#..#....##..#..#.#.#...#.#
#...#...#.....#..#........#.##...#..#....#..###..#..#.#.##.#..#..#...#..#.#.#..####..#..#..#.#.#.#.#
 ##.#.###.#.#..#..##.#.#.#.#...#.#.# #.###.#...#.#.# #...#.#.# #...##.#.#.#...#.....#.##..#.....##.#
#...#.#...#..#..#...#..##..#.##..#..#......#.#...#.##..###.#..#..###....#..#.#..##.##....#..##.#...#
#.##..#.#..#.### ##..#...#.#...##.#..##.#.#...##.#...#.#...#.#..##...##.##..##.#..#...###.##...#.## 
#.#..#...#.##...#..#.#.#....##.....#.#...#..##....##.#.#.##...#....#..#..##.#..##...###.....####.#.#
#..#..#.##..#.#..#.#..##.####..#.#.#..#.#..#...##..#.#.#.#..#..#.##.##..#.....#..#.#....###.#....#.#
#.#.#.#...###.##....#...#....###.#.##..#..##.#.#.###.##..#.#.#..#.....##..####.#...#.####.#...#.##.#
#......##.......#.#...#...##.....#...#...#...#..........#.....#...#.#....#.......#.........#.#.....#
 ######  ####### # ### ###  ##### ### ### ### ########## ##### ### # #### ####### ######### # ##### 
