 # ##### ####### ### ####    ####### ####  # #### ### #### #### ### #### ### ##  ## #   ######   ## 
#.#.....#.......#...#....#  #.......#....##.#....#...#....#....#...#....#...#..##..#.# #......# #..#
#.##.#.#..##.##...#.##.#..##..###.#..#.#....#.#.##.#.#.#.#..##..##...#.#..#.##....#...#..####..#..# 
#..#.#.#.#.#.#.####...#.#....#...#.#.#..#####.#.#..#.#.#.#.##.#....###...##...##.##.#...#....#...#.#
 #.#..#..#.#.#.#...##.#...#.#..#...#..#.......#...#..#.#......###.#...###..##.#..#..#.##..##.#.#...#
 #..#...#..#.#...#..#..#.#..###..#..#..####.#.####.#.#.####.##....#.#.#..#....##...#.#...#......##.#
#..#..##..#...#.##.#.#..#..#...##..# #.#...#.......#......##...##.#.#..#...#.#.#.###.#.#..####.#.#.#
#.#..#...#..##..#....#.#..#..#...#.##....#..####.#.#####.#...##.###..#.##.#..#.......#.#.#....#..#.#
#..#...##..#...#..##.#..#...# ##.#....##..#.#..#..#.....#..##......#.#...#.#..######.#.#.#.##.#.#..#
 #..##.#..#..##..# #.##..##..#...#####..#.#.#.#..##.###...#...###.#...##....#.......#...#...#.#...# 
  #..#.#.##.#.#.#.#....#...#.#.##.....#..#..#...#...#..##..#.##.#..#.#.##.#.#.###.#..#.#..#.#.####.#
 #.#..#..#..#.#....###..##.##...#.###..#.#.#.##.#.## #..#.#..#...#.#.#...#..##...#.#...#.#..#......#
#..#.#..##.#...###....#.##...##...#...#..#.....#..#.#..##..#...##..#.#.#..#..#.#....###...###.####.#
#.##.#.##..#.##...###.#...##...#.#..##..#.####.#.#....#..#.#.#..#.##.##.#..#....###.#...##...#.....#
#.#..#.#..##....#.#.#..##...##.##..#..#......#.#..#.#..#....#..#..#.....#.# ###...#...##...#..#.##.#
#.#.#..#.#...###....#.#..##.##....#.#...##.#.#.##..# #...###..#..#..###.#..#..#####.#.#..## #.#...# 
#...#.##..#.#....##.#.##......####...#.#..#.##...#..#..##....#.#...#..#..#...#.....#..#.#..#..#.#..#
#.##..#.#.#.##.##...#..###.#.#...##.#...#.....##..#.###...###...### #..#.##.#..###.#.#...#...#.# #.#
#..#.#..#.##...#.#.# #....#.#..#......##..###...#.#.....#.#...##...#.#....#..#...#.#.##.#..##...#..#
 #...#.##....##....##.###...#.#.#.#.##...#..#.#.#.#.#.##..#.#....#...#.#.#..#.##.#..#...##...##...# 
#.##.#...##.#..#.##...#...#.#.#.#..#...##.#.#..#...#....##..#####.##..#....##..#.#.#..##..##.# #.#.#
#...#..#...#.#.#...#.##.#..##.#.#.#..##......#..##.#.#.#...#........#..###.#..#..#...#..#.#...#..#.#
#.###.#..#......##...#...##...#.#...# #.#.##..#..#.##..#.###.######..#...#...#..#.###..##...#.##...#
#.....#.#.#.#.#...##.#.##...##...###.#..#.#.##.#.#...#.#.#...#....#.#.##..###.#.#.....#...###..#.#.#
 ###.#..#.##...#.##..#.#..##...#.#....#.#......#..##..#..#.##..##.#....#.#......#.#.#.#.##...#..##.#
#...#.#.....##.##...##...#.#.##....##.## ####.#.#...#...#..#..#.#..##.#..#.##.###.#.##..#..#.##....#
#.#...##.##..#..#.###.###......##.#.#...#...#....#.# ###..##.#....#....#.#..##...#.....#..##...###.#
#..##...#..#..#.#.......#.####...#...##...#..#.###..#...#...#.##.#..#.#..##....#.###### #...##.#...#
#.#.###..#..#..#.###.#.#..#...##.#.#...###.#...#...#..#..##.#.....#.#.#.#...###........#.#.#...#.## 
#.#....#...#.#.#...#..#..##.#.#...#..#......#.#..#...#..#.#.##.###..#.#..#.#...##.####...#..##.#...#
#.#.#.#.#.#..#...#.##.#.#...#.#.#.#.#..#####..#.# ###..#..#....#...#...#.#...#...#....##..#..#..##.#
#..#..#...#.#..#.#..#.##..###..##..##.#......#...#...#.##.#.#.##.##.###...### ##.#.##.#.#.##..#...# 
 #.##...##...##...###....#...#.#..#...#.##.##..##..##...#.#..#...#....#.##...#...#.#..#....##.#.#..#
#....##....#..#.##...####..#.#...#..##..#.#...#...#...#....#.#.###.##...#..#...##..##.#.##.....#.#.#
#.##.#.####.#....#.#....##..#.#.#.#.#..#..#.##.#.#..##.#.###.#.....#.#.##.# ###...#....##..#.#.#.#.#
 #...#......#.#.##.##.#...#....#.....#..#.#..#....#....##....###.##..##....#...##..#.#.#..#.#....#.#
#..##.#.##.#..##....#.#.##.##.#..#.#.#.##..#.#.##..###..#.###...#..#....####.#.# #..##..##...##.##.#
#.#.......##.#...###...#.......#..#..#....##..#..#.#...#..#...#.#.##.##.#....#..#.#.#.#....#...#...#
#..##.#.##...#.##....#.#.##.##..##..#..##...#..#.#...###.#.#.##...#....##.###.#.....#.#####.##.#.#.#
 #.#..#....##..#..###..#..#...#....#.##.#.##.#....#.##...#...#..###.###...#.#..#####.........#.#..# 
 #.#.# ###.#..#..#...#..#.#.#..####.....#.....###..#...##..#.###....#...##...#.......#.#.#.#.#..#..#
#..#..#...#..#.#...#..#.#.#..##.....##.#.####.#..#...##...# #....###..###..#.#.#.####..###..#..##.# 
#.#.#..#.##.##..###.#.#.#..#..#.####.#......#.##..###...#.##..#.#..#.#....#..#..#...#.#...#.#.#...# 
#...#.#..#.....#..#.#..#..#..#..#....#.#####...#.#....#.##...#.#..#..#.###..##.#..##..#.#.##..#.#..#
 ##.#.##..####..#...##..#..#...#.#.##..#....#.#...#.#.#..#.##....#..#....#.##..#.#...#..#....#...## 
#...#...#.....#..##..#.#.#..####....#.#..##.#...#.#..# #.#....##..#..###.#.#..#..#.#.#.#.#####.#...#
#.#.###..#.#.#.#...#.#.#..#.....#.#.#...#....###...#..#...####...#.#....##.#.#.#.#.#.#.#......##.#.#
#..#...#...#.#..##.#.#...# ##.#.#.#..###..#.#....##.#..#.#...#.##...##.#...#...#.#.###.#.#.##...#..#
#.#..#.###.#.#.#.#.#..#.#.#..#..##..##.#.#..#.#.##...#.#...#.#.#..##...#.#..#.#..#.....#.#..###...# 
#..#.#....#......#..#.#....#..#....##..#..#.#..#...##...##..#....#...##...#.#...#.#.###...#....##.# 
 #.#..###..####.#..#...#.#..#.####....#.#..#.#...#...##.#.#.#.####.##...#.##.##....##..#.#..##..#..#
#...#.#..#.#...#..#..#..# #.......#.#.#..#....###.##..#...#.#.#....#..#..#.....###...#..#..#.##.##.#
#.#.#...##.#.#...#..# #..#.######..#..#.#..###......#..##.#...#.###..#.#.#.#.#....##..#...#.......# 
#.#..#.#...#..###.#..#.#.#.#....#.#..#..#.#...#.#.#..#..##..#.#.#..#.#...#..# #.##...#..#.#.#####..#
#.##.#.#.## #.#.#..#.#.#.....##.#.#.#..#..#.#...#..#..#...#.#.#..#...#### #..#...#.##.#.#..##....#.#
#...##.#...#.....#...#.######...#.....#..#...### #..#..##.#..#..#.##.....# #..#.#..#..#..##...##...#
#.#.#..###..####.#.#.#......#.#.###.#..#..#.#...#..#..#.#..#.#.#...##.##..#.#.#.#.#.#.#.#...#..###.#
 ##.#.#...#....#..##.#.#.#.#...#...#..# #.....##..#..#...#.###...#...#..#...#.#...#.....#.#.###...# 
#...#...#..##.#.#....###.#.#.#.#.#..#..# ####.#..#..#.#.##....#.# ##.##...#.#..#.#.####.#..#....#..#
#.#..##.##.##....##.#...##...##...#..#..#....##.#.#.....#.###.#..#.#...#.# #..#.#......#..#..##.##.#
#..#.#...##...#.#...#.#...#.#...#..#..#.#.##....#.#.#.#.#...#..#....#.#...#..#....##.#.##...#..#...#
 #..##.##...#..##.###..##..#..###.#.#..##..#.#.#.....#....##.#.####.#.#.##..#..####..#...#.#..#..#.#
#..#...##.##..#...#..#...#.#.#...#...#...#..#.#..#.#..#.##...#....##..#...#.###.....# ##.#...#..##.#
#.#..##...#..#..##..#.##.#...#.#...#.#.#..#.#...#.#.#..#...#..###..#.#.##.#.....##.#.#...####..##..#
#...#...#..###.#.#.#..#..##.#...###..#..#...#.##.....##..##.#....#...#.....#####...#...##.....#...# 
#.##.##..##....#.....#..#...#.##...#..##..#..#.#.#.##...##...#.#..###..#.##.....#.#..##..#.#.#.#.#.#
 #.....#..#.###.#.####.#.##.#.#..#.##...##..#....#..#.#....#..##.#...###..#.###..#..#..#....#...#..#
 #.###.##.#...#...#....#...#..#.##...##...#.#.### #.#.#.### ##.....#....#.#....#...#..#..##...#..#.#
#..#.#..#..##.#.#.#.##.#.#...##...##.#..#.##.....#..#..#...#...####.#.#.#..#.#..###.#...#..###.#...#
#.##...#..#.#.#..#..#..#..###..##..#.##.#...##.#.#.#.#.#.#...##......#....#.#.#.#...#.##..#.....#.# 
#.#..##..#..#...#..#.#.#.#..##..#.#....#..#..#..##...#.#..###..#.####..##.....#.#.#......#..#.#.#..#
#..#.#..#.#..##.##.#...#.##..##.#.#.##..#..#..#...##...#.#....#.......#..#.##.#.##..####...#...# #.#
 #.#...#....#....#..###...##..#.#..#..#..#.#.# ##.# ###..#.##...#.###.#.#.#...#...###...#.#..#..#..#
#..#.#.#.##...##..#...#.#...#....#..#.##..#...#....#....#....#.#.....#.....#.#..#....##....##.#.#.# 
 #.#..#...###..#.#.##....##.##.##.#.#..##.###...#.#..####.##.#.####.#..###.#.#.# ###..##.##...#.#..#
#..#.#..##...##..#...####....#....#..#..#....#.#.#..#....#....#....#..##.#.#..# #...#...#...#.#..#.#
#.# ##.#...#.#..#..##....#.#.###.#..#.#..###.#.#.#.#..##..####..##...#...#..#..#..#..##.#.#.#.#.##.#
#.##...#.##...#...##..##..#......##...#.#..#.##....##...#......#.#.##.#.# #..#..#.##..#..#..#..#...#
#....##..#.##..#.#...#..#..#.###...##.#.#.#.....##...#.#.#.#.##...#.....##.#.##.#..#.# #..#..#...#.#
#.###.#.#....#..#..##..#.#..#...####..#.....##.#..##.#.#..#.#.#.#...###....#..#..#.#..#.#.##..####.#
#.#...#.#.##..#.#.#..#....#...#......#.#.####..##....#...#.....#..##...#.#.##.#.#..##...#...#.#....#
#.#.#.#.....#.#...##.#.##.####.##.#.#...#....#...###.###...###.###...#....#....#..#..#.#..#.#.#.### 
#...#.###.##..#.##.#....#.......#..#..#...##.#.##...#...###..#....##..##.#..###..#..#...#..#..#....#
 ##..#...#...#.#.....####.##.##..#.#.#.###...#..#.#...#....#.####..##.#..#.#....#.#..#.# #.#.#.##.# 
#.##.#.#...##..#.#.##....#...#..##.#.#....#.# ##...#.#.#.##......#....#.#..##.##...#.#..##...#.#...#
#....#.#.##..#.#..#.#.##.##.#..#...#..#.#.#..#...#.###......##.#..##.# #..#....#.#....#...###..#.#.#
#.##.#..#...#...#...#.#...#..##..## #.#.#..#...## #...##.#.#...#.#....#..#..###..#.###.##....#...#.#
#.#.# #...#.#.#.#.#.#.###.##..#.#..#..#..#.###...##.#...##..##.##..##..#...#...#.#.....#..#.#..##.# 
#.#..#.###..#.#..##.#...#....##..#..#..#.#....#.#...#.#.#.#..#...#...##.#.#..#..#..##.#..#..#.##...#
#..#...#..#.#..#.....##.####...#.##..#.#.#.##..#..##.#..#...# ##..##.....# #..#..#.#..#.# #.#.#..#.#
 #..#.#..#..##..##.###......#.#.....#..#..#.#.#..#....#.###..#..#.#.####..#..#.#..#..#...#..#.#.#..#
#.#.....#..#...#..#...#.#.#..#..##.#..#.#.#.#..#..#.#......#...##...#...#.#.#...#...#.##.#.#..#.#.# 
#..####.#.#..##..##.#.#..#.#..#..##..#....#...#.#..#.#.#.#..###...#.#.#...#.##.#.##.#..#..##.#..#..#
#.##....#..#....#...#..#.#..#...#...#..##.#.#.#..#....#.#.#.....##..#..###...#....#.##..#....#.# #.#
#.#..###.#.#.###..##..##.#.#.####.##..#....#..#.#.###.#....##.#..### #.#..##.#.##.#...#..####..##..#
#...#....#..#....##.#.#......#....##.#..##.#.##.....#.#.##.##.#.#...#..##....#..#.#.#..#....#.#...# 
#.#.#.##..#...###...#..#.#.#.#.#.#....##...#.#..##.#..#.##...#..#.#...#...###.#.#.#..##.#.#..##.#.# 
 #...#...#.####...#.##..#.#.#...#.####...###.#.#.#.#.#....##..##...###..###......#.#......##.#..#..#
#..#...#........##....#.......#........##......#...#...##...#....#.....#....#.##.....#.#.#.....# #.#
 ## ### ########  #### ####### ########  ###### ### ###  ### #### ##### #### #  ##### # # #####   # 
