 ###### ### ## ######### #### #######  ### ##### ####### ##### # ###### #  ####  ##  ### ######## # 
#......#...#..#.........#....#.......##...#.....#.......#.....#.#......#.##....##..##...#........#.#
 ##.##.#.#..#..#.##.##.#..##..#.####....##..#.##..##.#.#..###.....#####.....##....#...#...####.#.#.#
#..#.#...#.#.#.#..#...#..#..#...#...#.#..#.##....##...##.#...###.#....#.####  ##.#..## #.##...#....#
 #...####..#...#.# #.#..#.#..###..##...#.#...##.#...##...#.#...#...##...#...##...#.#..#..#..#.#.#.# 
 #.#....##..##....#..#.#....#....#.#.#..#..##...#.##.#.##.#..#..###..###..##...##..##..#...#..#.#..#
#...#.#...#.#..###..#..###.#..#.#..#..##..#.#.###....#.#....# #.#...#..##..#.#..#.#..#.#.##.#..#..# 
#.###..#.#..###...#.#.#.....###...# #.#..#..#....###.#..###..#..#.#...#...#..#.#..#.#...#....#..#..#
#.#...#.##.#....#...#.##.##.....#.# #...#..#..##.#....#...#.#..##..#.#..#..#.###.##...#...#.#.#..#.#
#.#.##.....#.##.#.##.....# ####.#..#.#.#..#.##.#..###..##...#.##..#..#.#..##.....#..##.####....#..# 
 #..#..#.##...#..#...#.#..#....#.#....#..#......#....#.# ####...#.#.#...#...###.#..#.......#.#..#..#
#..#..#.#...#.##.#.##.#.##..#.#...#.#...#..##.#..#.#.#..#....##..#...##.###....#.#...##.#.#.##.#.#.#
#.##.#..#.##....##.#.......##.#.#..#.##..#.#.# #..#..###..##...#.#.#..#...####.....###...#.......#.#
#....#.##.#.###....#.######...#.#.#....#.#....# #..#...#.#.#.#...##.#...##...####.#....##..##.##.#.#
#.##.#.#..#...###.#..#....#.##..#.#.#.##.####..#..#.##.#.#..#.###....#.#...#.....#..#.#.#.#.#..##..#
#.#..#...#..#....#..#..##...#..#.##.#.#......#.#.#.....#..#.......##..##.##.#.##..#..#..#.#...#...# 
 #..#.#.##.# ##.#..#..#..###..#.....#.#.##.#.#.#.#.#.#..#..#.#.##...#....#...#..#..#.#.#..#.##..#..#
#..#....#...#...##..#..#...#.#..###.#...#.# ##.#..#...#..#..##..##.#.#.###.#...#..#.....#..##..# #.#
#.#..#.##.#.#.#...#..#..##.....#...#..##...#...##.#.#..##.#...#...#...#....#.##..#.##.#.##.#..#.##.#
#.#.#.#....#..#.#..#..#...###.#..#.#.#...#...##.#..#.#.....##..#.#..#..##.#...#.##.....#...#.#.....#
#.#....####..#...##..# ##....#..#..###.##.####..#.#...##.#.#.#...#.#.#....#.#.#...####.#.#.#.#.#.## 
#..#.#.....#..###...#.#..###..#.#.#....#......#.#...#....#...####..#...#.#...#.##.#...##..#...#....#
 #..#.#.##...#....##....#...#.#.#...###..##.#.#..#.#.#### ##....##.#.#..#.#.#...#...#...#..##..#.#.#
#.#.#..#.##.#..#.#.#.#.# #.#..#..###...#..#.#...# #......#..###.....#.##...#..#..#.#.##..#...#..#..#
#.#..#......#.#.##...#..#...#..#.....#..#.#.#.#..#..##.#..#...####.#...#.#..#.##.#.#...#.#.#..#.#.# 
#.#.#..#.###..#...###.#..##..#..#.### #.##..#..##..#.#..#.#.#....#.#.#...#.#...#..#..#....#..#..#.# 
#.#.#.##.#...#..#......#....#.#.#.#..##..#.#.#..#.#...#..#..####.#.#..#.##...##.#...#.#.#...#..##..#
#.#..#...#.#..#..####.#.#.#...#.#.##...#.#.#..#.#...#.#.#..#...#...##..#..###....###...#.###..#...# 
#..#..##.#.#.#..##....#...#.#.#.#..#.#.#.#...#.#.#.#..#..#.###..###..#..#...#.##.....#.......#..##.#
#.# #...#...#..#...###..#..#..#.#.#..#.#.#.#......#.#..#.#.....#....#.#.#.###.#.#.### #.###.#.#.#..#
#..#.##.#.#...#..##..#.#.#.#.#..#.###..#..#..###.#....#...##.#..#.#...#...#...#..#...#.#...#....#.# 
 #....#..#.### #...#.#.#.#.#.#.##.....#..#..##.#.#.#.#..##.#..#..#..#.##.#..##.#...#....##.#.#.#..# 
#.#.##.#......#.#.#..#.#.#.##..#.##.#.#.#..##..#....#..##...#.#.#..#...#.#.#...#.##.#.#....#..#.#..#
#...#...#####.#....#.....#..#.#..#..###..#....#.#.###.##..#..#....#.####.#..#.#...#.#.##.#.##.#..#.#
 ##...#.....#..#.#.#.#### #.#.##...#...#..#.#....#....#..#.#.#.#.#.......##.#...#...#..#.#..#.##...#
#...##.####..#..##..##...#..#..#.##..#.#.#.#..#.#..###..#....#..#..######.#..#.#.##..#..#..##...#.# 
#.##......#.#.#.#..#...#...# #..#...#..#.#...#.#..#...#..##.#.#.#.#........#..#....#.##..##...##...#
#...#.###...#.#.#.#..##.##..#.#.##.#..#..#####...#..#..#..#.....#..#.#.#.#..#...##.#..#.#...##...#.#
#.#..#...##...#....#.#..# #.#.#....#.#..#.....#.# #.#.#.#..#####..#..#.#.#.#.### #..#.#.#.##..###..#
#..#...#...##..####...#..#..#..####..#.#..###....#..#.....##....#..#..#...#.....#.#.#.#.#.#.#.....# 
#.#.#.#.##.#.#.#....#..#.#.#..#...##.#..#....###..#.#.####...##..#.##..#.#..#.#...#..##......##.#..#
#....#..#..#...#.#.#.##..#...#..##...##.#.##....##...#.....##..#.....##....#.# #.# #...###.##...##.#
 #.#...#..#..## #..#....# #.# #.#..##.#.#..####...#.#..#.##..#..###.#...####..#...#.##...#....##.#.#
 #..### #.#.##.#..#.#.#..#...##...#.#...#.#....##...#.#.#..#.#.#...#..##....#..#.#...###..####...#.#
#..#...##.#.....#...#..#.#.##...##....#..#..##..#####.#...#......##..##..##..#.#...##....#.....##..#
#.#..#....#####.###..#..##..#.###..#.# #.#.#...#......#.##..##.#.#..#...#...#...##..#.### #.####..# 
#..#..##.#....#.....#.#...#.#.#...##..#..#.#.##..#####..#..#..#..#.#..###.##.#.#.#.#..#..#.......#.#
 #..#.##.#.##...####...#.#..#.#.##..#..##..#.#..##....#...#..#..##...#....#........#.#..##.##.###..#
#.#.#...#..#.#.#.....###...##.#.#..#.#..#.#..#.##..##.#.##..#..#...##.#.##.#.##.###...#.#..#.#...#.#
#.#..##.#.#...#..###....#.#...#.#.##..#.#..#...#..#...#.#.#.#.#.###...#.#...##..#..##.#...##...##..#
#..#..#.#.#.#...#...###..##.##..#...#.#..#..###..#.##...#...#.......#.#.#.#....#..#....#.##..#.#..# 
#.#.#.#..#...###..#...##....#..#..#.#..#..#...#.#....###.#.# ##.#.###...#..#.##..#..#.#..#..#....#.#
#...#..#..#.#....#..#..#.###.#...#..#.#.#..##.#.#.##.#.#....#.#.##...###..#..#.#.#.#.#..#..##.##...#
#.##..#.#.#.#.###..#.#..#.....###.#.#.#..#.##...#..#...#.##......#.#....#..#.....#.#.#.#.##....###.#
#.#..##.#...##....#....#..##.##.....#..#.#...###..#.##...#.#####.#..#.#..#..#####..#...#...#.##...# 
#..#.....###...#.#..###..#.#....#### #....##.#...#....###.......#..#.#.#..##......#.#.#..#.#.#..#..#
 #..###.#....##.##.#....#...###.#...#.#.#..#...##.##.#...#.##.#.#.#.....#.##.#####..#...##.#...#.#.#
 #.#..#.#.### #....#.### #.#...#..#.#...#.#.##.#.....#.#...#...#..#.###......#.....# ###...#.#.#...#
#..#.##.#.#..#..##.#....#....#...#...#.#..#...#..#.##...##.#.#.#.# #...##.###.#.#.#.#....##.#.#..## 
#.#.....#..#.#.#..#..#.#..###.###..##..#.#..##..##....#.#..###.#..#..#...#....#.#...#.##.#.....#...#
#...####.#.#.#.##..#..#..#.......#....##..#.#..#..#.##.#..#...#.#.#.#.##.#.##...###.....#..#.#.#.#.#
 #.##..#...#.#...#.##...#..###.#..##.#..#.#...##.#..#....#..#...#.#...##.#...###...####...#.#..##..#
#..#..#..#.#.###.#...#.#..#...#.#...# #.#..##....#.##.##..#..##.#..#.#...#.#.....#.#...#.#..#.#...# 
#.#..#..##.#.....#.#..#.###.#.....#..#...#...###..#.....#..#.##..#...#.##..##.###..##.#.#.#....#.#.#
#..#...#...#.#.##...#.......##.#.#.#...##.##...#.#..##.#.###...#..##.#..#.#..#...#....#...####.#...#
 #..#.#..##..##.#.##.#.#####....#...#.#.....##.#..#..##.....##.##...#.#.#...##.#..#.#.#.#....#...#.#
  #..#..##..#...#.#....#....####..#..#..#.###..##.#.#...###..#...##...#..###...##..#.##..###..#.#..#
 #..##.#...# #.##.#.##.#.##.#....#..#..#..#...#...#...##...#..##.#..#..#...#.##..#......##..#.#.### 
#..#...#.##.#.....#...##..#...###..##.#..#..##..###.#.#..#..#..#.#.#..#.##.#.##.#.#.####...#..##...#
#.# #.##..#...####.##...#..#.#..#.##...#.#.##..#...#...#.#.#.#.#.#.#.#...#.#......##.....#..#....#.#
#..#..#.#.#.#......# ##..#..#..##....##..#...##..#.#.#...#.#.#...#.#...#.#..#####....#.##.#..#.###.#
 #.##.#....#.#.###..#...#..#..##.#.##...#.##....#..#..#.#..#..#.#..#.#..#.#.#....#.#..#...###.#....#
 #..#..#.#...##...##..#..#...#....#.#.##...#####..#.#..#.#...#.#..#.#..#..#.#.##..# #.#.#.....#.##.#
#.#..#.#.###....#...#.#.#.##..#.##..#....##....#.#...##...###....#....#..#..#.#.#..#..#..####.#.#..#
#..#.#..#...###.###...#.....#.#....#.##.##..##...##.#...#.#...### #.##.#.#.##....#...#..#...#...##.#
#.##..#...#...##...###.#.#.#...##.#...#.#..#..###.....##..#.##...#..#..#.#...#.#..###..#..#..###...#
#...#..#.##.#....#.....#.#.#.#....#.#...#.#..#....#####.#.#.#..#.#.#..#...#.#.#..#...#.##..#...#.#.#
 #.#.#..##...#.##..###..#..#..#.##..##.#..##...#.#......#...##.###..#...#.#...#.#..#.#...#.#.#..#..#
#....##.#..#..#..##...#..#.##..#...#...#.#...##..#.##.#..###.#....#..#.#..#.#.#.#.#..###..#...#.#.# 
#.##..#..##.#..#....#.##.#..##.#.##.####.#.##...#...#.##.#.#...##..#...#.#..###...#.#...#.#.#.#.#..#
#.#.#..#.....#.##.##...#..##...#.#........#...##..#.#..#...#.##...#.###..##....##.##..#...##..#.#.# 
 #....#.####.#....#..#..#.#..###...####.#...##...##..#..#.#...#.##....##..#.##.##..#.#.#.#...##.#..#
#..###.....#.#####..# #.#...#...#.##...#.##..####..#..#..#..#.#.#..##...#..#.#....#..#..#..##....#.#
#.#....#.###......#..#.#..##..#..#...#.....##....#...#..#..# #..#.#  ##..#.#.#####..#.#..#.#.##.#..#
#.#.####....#####.#.#...##...#.#..#.#.#.##....##..##..#..#..#..#...##.#.##.#.....#.#..##...#.....#.#
#.#.#...###.#...#..#..#....##...#.#.#..#.##.##.##.#..# #...#..#..#....#.#...####.#..#...#.##.#.##..#
#...##.#..#...#..#.#.#.####...##..#.#.#....#.#..#.##..#.###..#..#.###.#...##.....#.#..#.#...#.#...# 
#.##....#.####..##...#.#....#.##.#..#...##....#.#...##.....#...#....#.###....#.#.#...#..#.#...#.##.#
#....##.#.....#...###....#.# #...##..#.#.##.#...###....###..#.#..##..#...#.#.##.#..#..#..##.#...#..#
 ##.#.#..#.#.#.##....##.#...#..##..#..#...#..#.#...####...#.#.#.#.##...#.#..#....##.#..#.#..#.##.#.#
#..#...#.#.#...#.#.#...#..#..#.#..#.#...#..#..#..#.....#.#..###.#..###.#.#.#..##.....#.#..#..#...#.#
 #...#.#...#.##....###.#.# ###.#.##...##..#.#.#.#.####.....#.....#....#..##..#..###.#...#.##...##..#
#..#..#.##..#...###..#.#..#....#....###..##.....#....###.##..###.#.#.#..#...#.#...#..##.#...##.#..# 
#.##.#...#.#..##...#.#...#..##.#.###....#...####.###....#.##.#..#..#.#.#..##...##..#.#...##..#...#.#
#.#....#.#.#.#...#....#.#..#..#.....#.#.#.##........#.##......#...#..#..#.#.#.#...#...##...#..##.#.#
#..#### #..#..##..###...#.# #...#####..#..#.##.##.#.#....####..##..#...#..#.#...##.##...##..#..#...#
 #.....##.# #...#....###...#..##.....#.#.#....#.#.#.##.###...#...#.#.##..#....##.....##...#.#.#.##.#
 #.###.....#.##.######...#..##...###...#..#.#.#...#...#....#.###..#....#.#.####..#.#...##.##..#..#.#
#.....#.##....#........#..#....##....#..#...#...##..#...#.#......#..##...#......#...##.......# #...#
 ##### #  #### ######## ## ####  #### ## ### ###  ## ### # ###### ##  ### ###### ###  #######   ### 
