 # ## ### ##### ####  ###### ## ### ######## #### #### ############  ###### ######## # #### #### #  
#.#..#...#.....#....##......#..#...#........#....#....#............##......#........#.#....#....#.# 
#..#..##...###...##...#.#.#..#...#...##.##.#..#.#..#.##.###.###.##....##.#..#.###.#.....##...##.#..#
 #..#..#.#....###..##.#..# ##..##.###.#.#....#.##.#..#..#..#...##.##.#..#.#.#...#..#.#.#..####...#.#
  #..#....#.#.....#....#.##...#.......#..##.#.....#.#..#..#..#.....#..#...#.#.#.#.#...#.#......##..#
 #.#..###..#.#.##..#.#.#....###.#.##.# #...#..#.###.#.# #...#.#.### #..##....#..#..#.#...#####....# 
#...#....##...#..#..#..#.#.#...#...#..#.##.#.#.##...#..#..##..#....#.#...#.#.#.# #..#..#......###..#
#.#..###....#.#.#.#.#.##..#..#..#.#.#....#.#.#....##.#..#..#.# #.#....##..#..#..#.#..#..##.##...### 
#..##...###.#.#.....#...#..#..#.#.#..#.#.#...#.##.#...#..#.#..#.#.#.#...#..##.#...##..#...#..##....#
 #....#.#..#...###.#.##.#.#..#..#...#..#..###...##..#.##.#..#.....##.##..#......##...# ##.##...###.#
#.#.#..#..##.##....#.#..#..#.#.#.###..# #.#.#.#..#.#......#..#.###.....#.###.###.#.#.##.#...##...#.#
#...##...#...#..#.#....#..#..#.#.....#  #...#..##...#.###..#.#...#.###.#....#....#.#.....##.#..#.#.#
 #.#..##..#.#..#...#.#.#.#..#..##.#.#.##.##..#....#..#...#.#.#.#.#...#.####...#.#..#.####...##..##.#
 #.#.#..#.#..#..#.#...#....##.#....#.....#..#.#.##.#...#..#...#...##.#......##..#.#.#....#.#..#.#..#
#..#.#.##..#..#..#..#.#.###...####..###.#..#...#...#.##.#..##..#.#.#.##.#.#..###..#...##.#..#.#.#.# 
#.##...#.#..#.##.#.##..#..#.##....#...#...#..#...#..#....#...#.....#..#..#.##....#..##.#..#.#...#..#
#...##....#.#..#.##..#..#.#...#.#..##.#.##.#..###.#...##..#.# ##.#.##.#.#.....##.##....##.....#..#.#
#.#.#.#.#.#..#.#...#.#.#...##...#.#...#.#...#......#.#.##.#..#....#....#..####.#...###...###.#..##.#
#.#.#....#.#.#..##.#.#..##..####..#.###..##..##.##.##......#..#.##..##.#.#...#.###...#.#....#.##...#
#.#.##.#.....##....#..#.#..#....#.#.#..#..##...#.#...#.##.#.#..##..#...#.#.#......##..##.#.#.....#.#
#.#...#..##.#..#### #...#.#..##.#.#.#.#.#....#.#..##.#...#...#...#..#.#...#..##.#.#..#...##..#.##..#
#.#.#..###..##.....#..##..#.#.#.#...#...#####..#.#.#..##.#.#..##...#..###..#..#.##..#..##.#.# #...# 
#..##.#...#...###.#..#...#....#.####..#......#.#.#.##.##...##..###..##...#..#.#....#..#...#..#..##.#
#.#...#.#..##...#.#.#.##...####.....###.#.#.#..#....#...###..#...###...#.#.##..###.#.#..#.#.#..# #.#
#.#.#.#..#..###...#.#...#.#....#.##....#...#..#..##..##.#..#.###...#.##..#...#....#....##.#..#..#..#
 ##..#..#.#...####....#..#..##..#...##...##..#..#.#.#...##......##...#.#.#.#.##.#.#.#.#...##.#.#..# 
#...##.#...##.....##.#..#..#.#.#..###..#.#..#.#...#.#.##...#.##.# ####.#.#.#..#..##.#.####...#...#.#
#.##...#.#.#.####...#..#..#..#.#.##...#.##.#...#.#..#.#.##..#.#..#.....#..#.#..##....#.....##..###.#
#.#..##..#......#.#.#.##.#.#...#...#.#.......#.##..#..#...#.#..#...#.#..#....#.##.##.#.#.#.# ##....#
#...##..#.#####..#....#..#..##..##..#..####.#.....##.#.#.##..#..##.#..#.#.##.#......#..###..#...#.# 
#.##...##.#....#..####..#.#...#...#...#....#.#.#.#...#...#..#..#..#..#...#.#..####.#..#...###.##...#
#....###...###..#....##....#.#.##.#.###.##.#....#..##.#.##.#.#.##.#.#..#...##.....##.#..#.#...#..#.#
 ###.#...#.....#.###..#.##.#...#..##....##..#.#.#.##....#..#....#.#.#.#.##...#.##.#..#.##...##..#..#
#...#..##..#.#...#...#...#..#.#..#.#.#.#..#.##.#..#..###..#.#.#...#..#...#.#..#...#.#..#.###.#.#.#.#
#.#...#..##...###..#.#.##..#...#.#...##.#........#..#....##.#..#.#.#..##..#..#..##....##.....#....# 
#.#.#..#....##....#.#...#.#..#...##.#...#.#.#####..#..#.#....#.#...##.#.#...#.#...#.#.#..#.#..###..#
#..# ##.##.#.#.#.#...##.#..#.#.##.#...#..# #.....#..#..#..#.##..##..#...#.#.#..##.#.##..# #..#..#.# 
 #..#.....#..#..#..#.....#..#..#..#.## #..#..#.#..#..#.##.##...#..#.###..#...#..#.#...#..#..##.#...#
#.#...###..#..#..##.#.##..#.#.#.#.....# #.#.#...#.#.##..#....###.##....#.#.#...#..###.##.#.#...#.#.#
#...##...#...#.#.....#..###.#.#..#.##..##.#.####..#...#.####.......#.#.#.##..##..#..#...#....#.#..# 
#.##...#..#.#...##.#...#....#..#..#  ##...#.....#..##.#.....####.###.#.#...##...#.#..##...#.#..##..#
#....##.#.#...#.#.#.##...###.#.##..##...##.#.##..#....##.##.#...#...##..##....##...#...###...#..##.#
 ####.#.#..##.#.......###....#..##....##.#...#.#..#.#...#.#...#.#.#.#..#..####...###.#.#..##..##...#
#.......##...#.#.#####....### #...#.##...#.##...#.##.#.#..####..#.#.#.#.#......##....#..#....#...#.#
 ##.###..###...#.#.....#.#...# ##.#.#..###.#..#.#.....#..#.....#..#.#.#...##.#.#..###.#...###..##..#
#...#..#....##.#...####....#..#.#...##.....##..# #.##...#..###..#.#...#.#..#..#..#..#..###....#...# 
#.#..#...#.#...####....####.#....###.#.####..#.##.#...#.##....##...#.#...#..#.#.# #...#....###..##.#
#..###.#..#..##.....#.#......##.#....#.#....##....#.##....###...##.#..#.#.#..##.##.#.# #.##..#.#...#
 #....#..##.##..###..#..#.##..#...####..#.#.#..#.#....##.#..###..#.###.....#.#.......##..#..#..#.#.#
  ###..##...#..#...#...#..#.#.###.....#.#.#...#..####..#.#.#...#.#....#.##.#..#.#.#.#...# #.#.#.##.#
 #...#..#.##..##.#..#.#.#....#...####.#.#..#.#..#.....#..#...#.#.####....#..#..#.#..#.##.#..#......#
#..#..#.#..###...##.##...###.#.#....#...#.#.#..#..#####.#.#.#..#.....#.#..##.#.....##.#....#.#####.#
#.#.#...##.....##....#.#.....#..#.##.#.#.#....#.#.#........#.#..####.#..#.....###.#...#.#.#..#.....#
#.#..##...##.##..##.#..#.###.#.##.....##...#.##...########....#....#..#.######...##.## #....#..#### 
#.##..#.##..#.##....#.#.#....#...##.##...#..#...##........###..###..#..#.....#.#....#.#..##..#.#...#
#..##......#.....####.#...#.#..#..#.#..##.#.#.##...#.####....#.....#.#...###.#..#.##....#...##...#.#
 #...##.#.##.##.#.....#.#..#.#..#.#.#.#.....#...#.#.#....###..####....###..#..#..#..#.#.###...#.#..#
#..#...# #...#.#..##.#...##...##..#...#.#.#..##.#.#...##...##.....###.#...#.#..#..#...#....##..#.#.#
#.#.##..#..##...##....#.#...#....#.###..###.#.#...#.##.#.#...####....#..#.#.##...#..#..###.#..#..#.#
#...#.#...#...#...#.#..##.## ##.#.....#....#...###.#....#..#.....###..#.#.....#.#..#..#..#..#...#..#
 #.#..####..## ##.#..#....#.#..#..##.#.###...#.......##..#..####....#.#..####..##.#..#..#.#.####..# 
#..#.#.....##.#...##..####...#.#.#.#......#.#.##.####...#.#.#...#.#.#.##.....#....#.#..#..#.....#..#
#.#....#.##...#.##..#.#....#...#....##.##..#.....#..#.##..#...#..#..#...##.#..#.##.#..#.#..####..#.#
#..##.##..#.##..##.#..#.###.##.#.#.#.#..#.#..##.#.#.#...#...##.#..#..##.#..##.##.....#...#....##...#
 #...#...#..#..#....#.#...#.#..#..#..#.#...#..##.....##..###....##.#..#..#..#....###...#.##.#...#.# 
  ##.#.##..#..#.#.#.#..##.#.#.##.#..##.#.#..#...###.#.##.....##......#.#..##.#.##...###....#.##..#.#
 #.#.#...#...##...#.##.#....#......#...#.###..#...#....#.#.#.#.###.#....#.....#..#.#...###.....#...#
#..#..##.#.##...#.#..#..###..####.#..#..#...#.###..#.#..#...#.....#.#.#..#.##..#.....#...#####.#.#.#
#.#..#...#.#..##.#.#.##.#...#...##..#.#.#.#.#....#..#.#...###.#.#.#..#.##....#..#.#.#.##.....#.#.#.#
#..#.#.###..#..#...#..#.#.##..#..#.#....#.#..###..#...###.#...#.#.##......###..#...#....##.#.#.#.## 
 #.#...#..#.##.###...#..#.#..#.##..#.###...#...#.#..##...##.##.#...#.##.##...#.#.#...#.#.#..#..#...#
#...#.#..##..#....#.#..#....#...#.#.#...##.###.#.#.#.#.#....#...##.#...#...#..#...###.....#.#.#.##.#
#.##.#.#...#..#.#.#..#..#.#.#.#...#.#.#..#...#.#.#...#..####..#..#..##...##..##.##...##.#.#.#.#....#
#......#.#..#.#.#..#..#.##.#...#.#....##..##.#..##.#..#.....#..#..#...###...##...#.#.#...##.#.##.#.#
#.#.##.#..#.#..#..#..#.....#.#..#..###..#..#..#...##.#.####.##..#..#.#....###..#.#.#..#.#...#..#.## 
#..#.#...#...#...#.#..#.##.#..##..#..#.#.#..#..##.#.......#...#..#.....#.#....##.#.##..#..#..#.#...#
 ##...##.#.##.###..##..#.....#...#.#......#..#.#..#.###.#..##.###.#.###..#.#.#...#...#..#..##...##.#
#...#...##.#......#...#..##.#..##...###.#.##....#.#....#.#..#......#....#...#.##.###.#.#.#...##..#.#
#.##..#.#....##.#.#.## ###.##.#.#.#.....#..##.##..####....#..#####..#.##..##....#....#...#.#..#.#..#
#...##....### #..##...#.......#.#..#.###.#..##...#....##.#.#.....##.## #.#...##...#.#.##.#.##.#.#.# 
#.#...#.##...#.#...##.#.#######..#.#.#...#.#...##.#.#.#.....####..#...#..#.##.#.##.#...#.##...#.#.# 
#.###..#...#.#..##..#...#.......#..#.#.#.###.##.....#..#.##.....#..##...#..#...#....#.##....#.#.#..#
#...#.#..##...#..#.# #.##.#.#.#..#.#...#.....#..#.##..#....#.#.# #..#.##.#.###.#.##...#.#.#..##..#.#
 #.#..#.#..#.# #....#.#...#.#..#.#..#.#.##### #.#...#..####..#..#.#..#...#...#.#.#.##...#..#...#.#.#
#..#.#..##.#..#..###..#.##.#.#.#.#.#.#..#....#..###..#.....#..#...#.#..#..##.#.#.#.#.#.#..#.##.#...#
#.#..#.#....#..#.#...##.#....#..##....#...#.#..#...#..##.#..#.###..##.#.#..#.#...#...#...#....#.##.#
 #..##...#.#.#.#..#.#...#.#.#.#...###.###..##.#..#...#...##..#...#.#..#..#.#..#.#.#.#.#.#..##....#.#
#..#..##..#..#..#...#.###.#...###...#....#....#.#.###.#.#..#...#...#.#.#.#.##.#...#....#..#..###.#.#
#.#..#..#...#.#.##.#..#....##....#.#.##.#..###..#.#...#...#.#.#.###..#.#.#..#.#.##..#.#..#..#..#...#
#...#..#.#.#..#...#..##.##...#.#.#.#..#..##....#....#.##.#..##......##....#...#....# #..# #...#.#.# 
#.#...#....#.# ##.#.#...#.###..#.#...#.#..#.###..###...#...#...#.###...### ### ###..#..#.#..#.#..#.#
#.#.##..###...#...#..#.#....#.#...#.#...#.#.#..#....###..##..##.#....##...#...#....##.#....#...#...#
 #...#.#...##.#.#..#.#.#.##...#.#.#..##...#.##..###....#..#.#...#.#.#...#...#.#.#.#...#.##.#.##..#.#
#..#.#...#.#..#..#.#..#..# #.##..# #....###...#...#.##..#.#..#.##.#...#..###.....##.##...#..#...##.#
#.##.####...#.#.#..##...#.#.#..#..#.####....#.#.#..#...#...#.#.#...###..#...#.#.#...#..#..#..#.#...#
#.#.....##.#..#..#...#.##.....#.#...#...####..#.##..##..##.#.#...##...#.#.#..#.#..##.##.#..#...#.#.#
#.##.#.#.....#.#..##.##...##.#...#.#..#......#...##....#...#..#.##..#..##.##.#.#.#.......##.##.#.#.#
#...#.#..###.#..#..##...##.#.#.#.....#.######..#...####..#..#..#...#.#.#...#...#.####.##......#..#.#
#.#.....#......# #....#....#....#.#.#.........#..#......# #..#...#...#...#..##..........#.#.#...#..#
 # ##### ######   #### #### #### # # ######### ## ######   ## ### ### ### ##  ########## # # ### ## 
