 ##.#.#### ## ### ### #### ### ######  ###### ##### #  # #### ##  #### ##### ###########  ### ### # 
#.P#.#....#..#...#...#....#...#......##......#.....#.##.#....#..##....#.....#...........##...#...#.#
 #..S.##.#..#..#...#..#.##..#...###.#...##.#.#.###........##.#.#...##...#.#...####.##.#....#...#...#
#.###..#...#..#.### #....#.#.###..#...## #.#.#....#.##.#.#.#.#...#.#..##.#.#.#...#...#.##.#.###..#.#
#....#..#.#..#.....# #.#...#.#...# ###..#..#.#####..#...#..#..###.#..#......#.#.#.##.#...#....###..#
#.##..#.#.##..####..#.# ###....#..#....#..#.......#..##..#..#......#...##.##.......#.#.#...##....#.#
 ##..#..#....#...##....#....##.##...#.#..#..###.#..#..##..#...####..###.#....#####.#....####..##..# 
#...#..# ###...#..##.#...###..#...#.#.#.#..#...#.#..#...#.#.##...##...#..#.##....#.#.#.#....#...#..#
#.##.#..#...#.# #...#..#.#...#..##...#..#.#..#...##..###...##..#..#.#..#.##...#.#...#.#..##..##.##.#
#.....#...#..#.#.##..#.##..#.##.#..###.# #.#..##..#.#...##...##.#..#.#.#....#..#..##....##.#...#...#
#.#.#.##.#.#.#....##.#....#...#.#.#.....#...#..#.#..#.#...##.....#...#..#.#..#...#...###....##...#.#
#.#.#...##...##.##...#.###.##.#.#.#.##.#..#..#.##..#...##..#.#.#.#.#..#..#.##..##..##....#.#..#.#..#
#..#.##....##....#.##.#......#..#.#...#..#.#.#...#..#.#..#..#..#.#.#.#..#....##...#..#.##...#..#..# 
 #.#...####.#.##.#.#....####...#..###...#..#.#.#.##.#..#..#..##..#.##..#..##...#.# #...#..#..#...#.#
#..#.#....#.....#..###.#...#.##..#...###.#.#.#.#..#..#..#.##...#.#..#.#..#  ##.#..#..#..##..##.###.#
#.....#.#..#.##..#.....#.#..#...#..#.#.#...#.#..#.##.#.##...##.#..#.#.#.#.##.#.##..##.#...##...#...#
#..#.#...###...#.######..#.#..##.#.#...#.#.#.####..#...#..#.#....#..#...#....#..##....#.#..#.## #.# 
 #.#.##.#....#.#......#.#..#.# #....##...#.#.....#.##.#.#.#..####..#.###.#.#..#...##.#...#...#.#...#
 #.#...##.##..#.#####....#.#..#..##...####..####.#..##....##......#......#..#.###..#.#.#..###...##.#
#..#.#....#.##......#.##..#.#..#...###.....#...#..#....#.#..##.#.#.#.#.#.##..#...#...##..#....#.#..#
#.#.#..###...#.####..##..#...#..###....#.#..##..#..####..##...#.....#..#....#..#..###...##.##.#..#.#
#.#..#.#..##.#....##....#..#..#...#.####..#....#..#....#..#.#..#.##..#..####..#..#..#.##...##.#.#..#
#..#.#..#.....#.#..#####..# #..##.#.#....# #.#.#.#..##..#....#..#..#...#....#..#...#...#.##...#..#.#
#.#..#.# #.##..#.#.......#.#.#....#..#.#..#.#.#..#.#...#..###.#...#.##...##...#.#.#..##..#..## #.#.#
#..#....#....#.#..###.###.....#### #..##.#.....#.#.#.##..#....#.#...#.#.#..###..#..#...##..#..##.#.#
#.#..#.#..##.#..#....#....##.#....# #.#..#.#.#.#...#...#.#.##.##.##....#..#...#..#..##....#..#...#.#
#.#.#...#..#..#.####...###.#...##..##.#.#..##..###..#.#..#..#......#.#...##.#...#..#..####..#..##..#
#..#..#.###..#.....#.##......##..#.....#..#...#...##..#.# #.####.#..#.##.#...#.#..#..##....#..#...# 
#.#..##.....#.#.##..##..#.###..#..##.#.#.##.#.#.#....#..# #.....#..#..##.##.#..#.#..#...##.#.#..#.# 
#.#.#..###.#...#...#...#.#...#.##.....#..#..##..#.###.#..#.##.#.#.#..#.....#..#....#..##.#...##.#..#
#..#..#...#..#..#.#..#.#...#.#....####..#..#...#.#.....#.#..#..#..#.#..###...#..#.#..#....###....#.#
 #.#.##.#...#.#.#.#.#...#.#..#.#.#.....#..#.#.#..#.#.#....#..#.#.##...##...#..#.#.#.#..##.#...####.#
#..#.#...###....#...#.#.#..#..#..#.##.#.#...#..#....#..##...#..#...####..##.#.#..##...# #..#.#.....#
#.#....##...##.#..###.#..#..#..##..# #...##..#..##.#..#..###.#..##.....#..#..# #...### #.#.#.#.#.#.#
#.##.#.#..#....#.#...#.#.##..#....#.#..#.# #.##...#..#.#......#.#.##.#..#..#..#.##....#..#..#..###.#
#...##.#.##.###..#.#.#.....#..####....##..##...##..##...#.#.#.#.#...#.#.#.#.#.....###...#.#.##....# 
 ##...##...#....##.#..###.#..#.....###..#...##...#...##...#.#.#...#...#.#.#...#.##...#.#..#...#.#..#
#.###...##...####..##....#..#..##.#...#..#.#..##.###....#.#..#..#..#.#..#..#.#..#..#.#...#.##..#..# 
#....##..#.###....#..###...#..#....#.# #....#..#....#.#.#..#...# ##.##.#.#.#.#.#..#..#.#...#.#..#..#
 #.#.#.#..#....###.#....###.##.##.#...#..##...#..##..#...##.###.#......#.#.#.#...#.#.#..###...#..#.#
#..#....#..#.##.....#.#...#.....#..##...#..#.#.##..#.#.#....#...#.#.####.#.##..##.....#.....##..#..#
 #.#.#.#.#...#..#.#..#..#..#.##.##.#.##..#..#.....#...#.###...#.#..#.....#....#.###.#.##.#.#.#.##.# 
#..#.#.#..###..#.#..##.#.#...#...#.....#...#..#.#..#.#....##.#...#..#.#.##.#.##....#....#..#.#.....#
#.#.#...#....#....#....#..####.#..####..###..#..####.#.#.#....###..#..#.....#...##..###..#....##.#.#
#.#..##...##..#.#..###..#.......#.#...#.....##.#.....#.##..#.#....##.#.#####..##..#.#..#.#.##...#..#
#..#...###...#...#....##.#.##.##..#.#.#.#####..#.#####....#..#.#.#...#.#....#....#..##....#...#..#.#
 #..##...#.##.###..##.#...##..#..#..#.##......#..#.....### #.#.##..##..#.##..###..#...#.#..#.#..#..#
#.#..#.#...#.....##.....#...##..# #.#...#.#.#.##.#.####...#..#...#....##.#..##...#..#.#.###..###..# 
#..#.#..#.#.##.#...###.#..#...#..#..###.#.#.##...#.#....#..##..#..###.#..#.#...##.##...#...#.....#.#
 #...##..#.....###....#..#.##..#...#....#..#...#.#.#.###.#...##.#...##..#...#.##...#.#.#.#.###.###.#
#..##..#..#.###...#.#..#.#....##.#.####...##.##.#..#.#....##....#.#...#.#.#.#...##.#..#..#....#....#
#.#..#...#..#...##.# #.#.#.####...#....#.##..#..#.#...###...##.#...##...#..#..#.....#.#.#.###...#.# 
#.#.#..##..#..#.....##..##.#....#.#.##..#...#.#.#..#.#...#.#.#..### #.##.#..#..####.#.#......###..# 
#.#...#.#.#..#..###....#...#####.#..#.#...###....#.#...#.#....#....#..#...#...#....##...####.#..#..#
#.#.#.#...#.#..#...####..##......#.##..###....##...####..#.##..###..#...#.####..##...###......#..#.#
#.##....##.#.#..##.#...#....###.##...#....#####..#....#.##...##...#.####.....#.#..##....#####...##.#
#...##.#......#.##...#.#.#.##...#.##..#.##.....#..#.##..#..#....#.#.....##.#.#..#...###.#...##.#...#
 ##...#..#.##.#...#.#...#..#..##....#...#..###..#..#...#.##..###...##.#...#..##..##...#...#..#.#.#.#
#...#.#.#.#.#.#.#..#..#.##.#.#...#.#.#.#..#..##..#.#.##....##....#.#.#.##..#...#.#..#.####.#.#.#.#.#
#.#..#......#..# #...#....#...#.##.....#.#.#..#.#.#..#..##.#..#.#..#....#.#..#.#..#.#......#..##.#.#
#..#..#####.##..##.##.###..##.#...##.##.....#.#.#...##.##...#..#.#..##.##..#..#.#..##.#.##..#.#..#.#
#.#.##....#...#...#.....##.....#.#..##.#.#.#....#.###..#..#.#.#...#..#.#..#.#.#..#...#....#.....#..#
#......#.#.##..##...#.#...#.#.##..#.....#..##.##..#...#..#..#.#.#.##.#..#.#.....#.##..##.#..####..# 
#.###.##.....#...#.# #.##..# #...#.#.##...#...#..#..##.##..#....#..#.##.#.#.##.#...##...#..#....#..#
#....#..#.#.#.#.#.#.#....#..#..##....# ###..##.#..#......#.###.#.#.#..#.#.#.#.#..#..###.##.#.#.#..# 
 #.#...# #....#.#.....##..#...#.#.###.#..#.#....#.#.#.##.#....#....#.#..#..#....#.#...#...#..#.#.#.#
 #..#.#.#..#.#..##.###.##..####...#.....##..#.#...#..#.#..#.#..#.##....# #.#.###...##.#.#...#..#...#
#.#..#....#...#..#...#....#....#.#.###.##.#..#..#.##.#..#..#..#..#..##..##...#..#.#...#.#.#.#.# ##.#
#..#.#.#.#..#.#.#..#.#.###..##...#.........#..#.#..#...#..#..#.#.#.#..#...###..#....###..#.#...#...#
 #...#.#..##.#..#.#..#.#.#.#..###..#.#.#.##.#.#.##..#.#..##.#.....#.#.#.##...#.#.###...##...#.#..#.#
 #.#.#..##...#.#.#.#.#.#...#.#...#..#...#.....#..#.##.#.#...###.#.#...#...#.#..#.....#.#..#...###..#
#...#.#.#..#...#.....#..#.#....#.##..#.#..#.#..#.#...#..#.#....#...#.#.##.#...# ##.#.#..#..#.#...## 
#.##..#.#.# ###.#.#.#..##..#####..##..#..#.#.##...##..#..#.###...##.....#...#..#..#.#.#..#..##.#...#
#.#..##.#..#..#...#.#.#...#.....#....#..##......#..##..#.#....##.#..#.#..###.#..#......#..#....###.#
#...#...##..#...#..#..##.#..#.#..###.##...#.#.##.##...#..#.##...#..##..#.#.#..#..#.#.#.##..##.#....#
 ##.#.#...#..###.#..#..#...#...#...#...##.#..#......##..#.#...#...##..#.#...#..#.#.###...#...#..##.#
#...#.#.##.#......#..#..#.#.#.#.##..##..#..##..#####..#.#...#..####..#..#.#..#.#.##...#.#.##...#.#.#
#.##...#....##.##...#.#.###.......#.#.#.##....#....##...#.#.#.#....#...##..#...#....#...#...#.#..#.#
#...#.##.##...#..###..#....#.####.#.#....###.##.##....## #..#.#.##..##...#..##..#.#..#.#..#..##.#..#
 #.#..#..# ##..#.#..#.####..#...#.#..###....#...#.#.##..#..# #....#...##..#..#.#...#..#..#.#....#.# 
#.#..#..#.#..#.....#......#...#..##.#...#.#.#.##....#.#...# #..###..##...#.#.#...#.####.#...##.##..#
#...#..#....#.#.##.#.####..###.#.#..#.#...#.#..#.#.#..#.#..#..#...#...#.#.....#.#.#.....#.#..#...#.#
#.##..#.#.##..#..#.#....#.#....#...#..####.#.#.#..# #.#..#...#..#..##.#.#.#.#.##....####...#..#.##.#
#.#..##.#....#..#...###.#...##..###..#.......#..#..#...#..#.##.#.#..#..#..##.#...###....###..#..#..#
#..#.....#.#.##..##...#.###..#.#...#...#####..#..#.##.#.#..#...#..#.##...#...#.##....#.#....##.#..# 
 #.#.#.#.#.#..##.#..###...#.#..#.#...###....#..#.#..#...#.#..##.#.#..#.##..#.#...#.##..#.##.#...#..#
#...#.#..#..#..#..##....###.#.##..###....##..#.#..#..#.#..#.#.#....#.#.#..##..#.#..#..#..#..#.##..# 
#.#...#.#.#.##..#..#.###....###..#....###..#.#.##..#.#...#..#...##.#..##.#..#.#...#..#..#..#..#..#.#
#..#.#..#..#...#.#.#.#.#.#.#....#..###....#..#..#.#...####.##.#..#.##......#...##.#.#.#.#.# #..#...#
 #.#...#.#...#...#.#.#.#.#.#.#.#.#.#...##..#..#.#..##.#....#..####...###.##.##.#.#..#...#..# #..#.# 
 #..###....##..#.#.#.#.#..#...#....#.##..#.##.#..#..#.#.#.#.##....#.#...#....#...#.#..#..#..#..##..#
#..#....##...##.##...#..#..#.#..##.#...#....#..#..#.#.#..#.....##....#.#..##.##.#..#.#..#..#..#..#.#
#.#.##.#..##......#.#..#.#.#.#.#...#.##..#.#..#..#..#.##..#.##..####...#.#.#....#.# #..#..##.#..#..#
#.....#.#...##.##..#.#...#.#..#..##..#..#..#.#..#..#....#.#...##....#.#..#.##.#.#..#..#..#....#.#.# 
 #.##.....#.#....#.....###...#..##..#..#..##.#.# #..#.#.#..##....##..#..#.....#..#.##.#.#..#.#..#..#
#.#..#####..#.##..#.##....####.#...#.##..#...#..#.#..#...#...#.#.#..#..#..####..##..#..#..#....# #.#
#...#.....#.#..###.#..##.##....#.##....##.#.# #....#.#.##.##..##.#.#..#..##...##...#..#..#.###..#..#
#.#..#.###...##.....#......##.#....#.#....#.##.#.###.#......#...#...#..##...#.##.##..#.#.#...####.# 
#..#.......#....#.#...##.#....#.##....#.#......#......#.#.#...#...#..#....#.#.......#......#.......#
 ## ####### #### # ###  # #### #  #### # ###### ###### # # ### ### ## #### # ####### ###### ####### 
