 #  #### #####  ### #  ### ###  ### ####  ### # #### # ##### ### #####  ##### ####### ## #  ## #### 
#.##....#.....##...#.##...#...##...#....##...#.#....#.#.....#...#.....##.....#.......#..#.##..#....#
#...###...#.##...#......#...#....##..##....#....#.##...#.##.#.#..#.##....#.#..#.##.#...#.....##.#.# 
 ##....#.#.....###.#.#.#.###..###...##.#.#.####.#.##.#...#....#.#....####..##..##..##.#..##.#...#..#
#.#.##..#.#.###...#..#.#.#...#....##...#..#...#.#.....##..###..#..####...#..##...#...#..#....#.#.#.#
#..#..#....#....#..#.#.#..#.#..#.#...#.##...#.#..####...#....##..#.....#..#..#.#..#.#..#..#.#....#.#
 #...#.#.#.#.###.#..#...#.#..#..#.#.#...#.###..#....##.#.###....#..##.##.#.#..#..##..#.#.#..#.#.#..#
#..#....#..#...#..#.#.#.#.##..#.#...#.#..#...#..###..#.....##.##..#..#...#...#..#...#..#.#.##.##..# 
#.#..##..#.###..#.#.#.#.#....#..#.#.#..#.#.#..#....#..####...#...#..#..##.##.#.#..#.#.#..#.#...#.#.#
 #..#.##.#.....#....#.#..#.#.#.#..#..##..#..#..##.#.#....#.#.#.##.#...#......#.##.###.##..#..##....#
#..#...##.#.#.#..###...#..#..#.#.#.#.#..##.# #..#...####..#..#.#..#.##..##.##...#.......#...# #.##.#
 #...#.....#.#..#....##..#..##..#....###...##.#.#.#....##.#.##..#...#..#...#.##..#.#.####.##.#..#..#
 #.##.##.#...#.# #.##...#.#.#.#..#.##....##...#..##.##..#.#...#.#.##..#.##.....#.#..#....#.....#.#.#
#..#...#.###.#..#..#..##.......#.#.#..###...#..#.#....#.#.###.#.#..#.#...###.#.#.##.#.##...####..#.#
 #..##.#....#.#.#.#.#..#.#.#.###...#.#...#.#..#..#.##.#.#....##..#..#..#....#..#..#.#..####...##...#
#.#.....#.#...#.#.#.##..##.##...#.#...##....#.#.#...##..#.##....#..#..#.###..#..#.#..#.....##....## 
#..##.#.###.##..#.#..##.#...#.#.#..##...#.#.##...#.#...#.#..####.#...#..#...#..#...#..####.#..###..#
 #.#...#....#..#..##..#..##.#.#..#...##.#.#...##..#..###...#......###.#.#.##..#.#.#.#....#.#.#....# 
 #...##..##..#..#...#..#...#...#..##..#..#..#...#...#....#..#.###.......#....##...#.##.##..#..#.#..#
#..#.##.#..#.##..#.##.#.##..##..#...#.#.#..# ##..### #.#..#.#...###.#.#.####.#..##......#.#.#...##.#
 ##.#...#.# #...#.......#.#....#..##..#.##..#..#....#...#..#.##...#.##.....##..#...#.####.#..###...#
#.....##...#..##.####.#...####.#.#...##...#.##.##.#...#..#....###.#...#####...# ### #.....#.##.#.## 
#.###..#.#..#.#.....#..#.#....##...#...##.#..#...#.#.# ##.###...#..##.......##.#...#..####.....#.#.#
#...##.#..#.#..#.##..#..#..##...#.#.#.#...#.#..#...#..#......###.#...#######.....#.#.#...#.#.#.#.#.#
#.#...#..#..##.#...#..##..#..##..#..##..##...#..#.#.#...####.....###.#......##.##....#.#..#...#..#.#
#.###...#.#..#..#.#.#.#..#.#...#.#.#...#.#.#..#.#...###.....###.#.....###.#..#...#####..#.#.#...##.#
#....#.#...#..#...#.#...##...#.#.#...#.#....#..#..##...##.#...#...###.....##.###......#.#..##.###..#
#.###...#.#..#.#.##..####..#..#..##.#...#.#..#...#...#...#.###..#...###.##.#....#.#.#.#..#.#..#...# 
 #...##...#.#...#...#.....#.#..#...#..#.#..##.#.# #.#.##.#....#..#.#...#...####..#..#...##.#.# #.#.#
#..#...#.#....#...#.#.#.##..#.#.##..#.#.###...#..#....#..#.##..#..#..#.#.#....#.#..#.#.#...#..#....#
#.#..#..#..##..#.# #..#....#..#.#.#..#......#.#.#..####.#..#.#..##..#..#..##.##.#.#..###.##.#.####.#
#.###..##.#..##...#..#.##.#..#.....#..##.#.#..##..#.....#.#...#....#..#.#...#...#...#....#..#....#.#
#....#....#.#...##..##..#..#..##.##.#...#...#....#.#.#.##...#..#.##..#..#.#...##.##.#.#.# #..###.#.#
#.##..#####...#.#..#...#.#..#..#.....##..#.#.##.#..#.##...##..#.#...# #...##.##..#..#..#.#.#...#.#.#
#.#.#......###.#..#..#.#..#.##..##.##..#.#.#...#..#.....#..###....##.##.##..#...#..#.#.#....#.#..#.#
#...#.####.....#.#..#....##...#....#..#..#...#..#..##.###.#....###.#....#.#..#.#..#..#..#.#...##...#
#.#..#...#.##.##..#..#.###..#..###...#..#.###.#.##...#...#..#.#..#.#.###...#...#.#..#.#.#..##...##.#
#.##.#.#..#.....#..#..#...#..#.#.#.##..#..#...#..##.#..#..#..##.#..#....##..#.##...##.#..#...##..#.#
#..##...#.#.##.# #..#.#.#.#.#..#.#..#.# #...##.#....##..#..#.#....# #.#.#..#....##.#..#.##.#.#.##..#
#.#...##..###..##.#.#.#.#..##.#....##..#.##.....###...#..#.#.#.##..# #...#...#.#.#...#..#..#......# 
 #..##...#...#....#.#.#..#.#..####...#.#...#.##....#.#.#.#...#..##..#..##..###...###.##..#.#.###.#.#
#..#.#.##..#.#.#.##.#..#.#...#....##.#.#.#..#...##...#.#..###.#...#..#...#.#...##......#.#..#...#..#
#.#....#.#.#.###.#..##.#..#.#..##..##..#..#.#.###.#.##..#.#...#.#..##.##..#..###..####.#.#.#..#...# 
#.#.#.#....#.....#.#....#.#.#.#.##....#.#.#.#.....##...##.#.#.#..#......#..#.#...#....##..#..#..#..#
#..#...#.##.##.#.#...##.#..#..#...###.#.#.#..##.#...#.#...#.#...#.#.#.##..#....#.#.##.#..#..#.#..#.#
 #.#.#.#.#......#.##.# #..#..#.#.#...#....##.#..#.#...#.##..####...#..##.#..#.#.##..#...##.#....#..#
#..##..#..#.#.##...#..#..##.##...#.#...###.#..##...#.#..#..#...#.#..#....#.#..#....#..##...#.#.#..# 
#.#...#.#..#...#.#..#..#.#..#..#...#.##.....#...#.#..#.#..#..#...##..#.#..#.#.#.###..#...##..##..#.#
#.###....#..##.#..#..#.#...#.#..#.#..#..##.#.##..#..#...##..#.#.#..#..#.#....#.....#.#.##...#...#..#
#....###..#..##..#.#...####...#.#.##.#.#..#....#..##.##..#.##..#..##.#..####..##.#..##.#.#.#..##.#.#
 #.#.#..#..#..#.#..##.#....##....#...#..#...##...#....##.#...#...#...#.#....#...# #.#....#..#..#...#
#..#..#..#.##.#.##...#..##..#.##.#.##..##.#.#.###..##..#..##...#.#.##....##..##..#...##.#..#.#..##.#
#.#..#.#.#....#...##...#.##.#...##.#.#.#..##.....#...#..#...#.##.#...###..#.#..#..##....#.#..##....#
#..#.#...####..#.#...##...#.##.#...#....#....###.#.#.#.#.#.# #...###....##..#.#.#...####...#..####.#
#.##..#.#...##.#...##.#.#.#..#.#.##..##..####..#.#..#..#...##..##...###...#.....#.##.....#..#....#.#
#...#.#...#..#.##.#....#..#.#..#..#.#.#.#.....#..#.#..#..##...##..#....##.#.##.##....####.##..##...#
#.#.#..#.# #.....#..##...#..####.#..#.#...#.###.#..#.#..##..#.#..#.###.##..##....##.#........##.### 
 #.# #..#.#.#.##...#..##..#......#.#...#.#.#....##.#..#.#..#..#.#....#....#...##.#.#..##.#####.....#
#...#.#.#....#..### #..#.#.##.###..#.#.#.....###...##.#...#..#..#.##.#####..#..##...#...#......###.#
#.#.....#.##.#.#...#.#.#.#.#.#...#.#.#..######...##.#..#.# ##.#.#...#.....#.#.#...#..##.#.###.#....#
#..##.#.#..#.#...#.....#.#.....#.#...#.#.......##....#..# #.....#.#...#.#...##..##..#...#....#..### 
#.#..#...#.#.#.##.#.##.#...#####..##.#.#.#.#.##.#.#.#.#..#..####.#..##.#.##....##.#.#.##.##.#..#...#
#.##...#.#.#.#.#....# #.###.....#...#..##..#.#....#....#...#.....#.#.#.....#####..#.#..#....#.#.#.# 
#...#.#..#.#..#..##..#......####..##..#...#..#####.#.#..### #.##...#.#.##.#......#...#..#.##..#....#
#.#..#..#..#.#..#..###.####.....#..#.#..##..#......#.###...#....###..#.#...##.##.#.#.#.##..#.# #.#.#
#..#.#.##.##..#..#.........#.##...#..##..#.#..#.##.#.....#..##.#...#...#.#.##..#.#.#.#....#...#..#.#
#.#..#.#..#..#..#..#####.#..#..####.#..#.#...#...#..#.###.#..#...#..#.#..#...#..##..#.#### #.#..#..#
 #..# #..#..#.#...##....#.#...#......#...####..#.##..#.....#..###.#.#.##..##..#...#...#...#..#.#..# 
#..#.#..#..#..#.##...##.#...#.#.#####.###....##...#.#..###..#.....#.#..#.#...#..#..##...##..#...#..#
#.#....#..#.#...#..##.#..#.#.#..#.........##...##.#...#....#.###.#...#.#.#.##.#..###.#.# #.#..#.#.# 
#...###..#....##..#....#.#.#.#.##.##.#.#.#.###.#..#.##.#.##....#...#..##.#.#..#.#.......#..##..#...#
#.##....#..#.#...#..##.#.#...#...#....#..#.....#.#.#...#..#.##..##..#....#..#...#.#.#####.#...#..#.#
#...#.##.##..#.###.#.#.#.##.#.##..#.#.#.#..#####....#.#..##..##.#.#..####.#.##.#...#......#.#.#.##.#
#.#.#......#.#.#...#...#..##....#.#.#.##..#.....#.#...#.##..#...#.#.#...#.#..#..#.##.#####.#..#.#..#
 #.##.####..##.#.###.#..#....##.#..##...#.#.#.#..# ##.#....#..###...#.#.#..#.#.#..#..#......#.#..#.#
#....#.....#....#....#.#..#.#....#.#..#.#..#...#..#.#.##.##.#....###..#..#...#.#.##.##.##.#..# #.#.#
#.##...#.#.#.###..####..#.#..#.##..#.#..#.#..#.#.#..#...#.#..###....#.##..#.#..#....#..#..##..#..#.#
#...####..#..#...#....#..#.#..#...#..#.#..##..#....# ##.#...#...#.#.....#.#..#..####..#.#...#.#.#..#
#.##....#..#..#.#..##..#.#.#.#..###.#..##...#..#.#..#.#..#.#..##.#..#####.#.#..##..#.#..##.#....### 
#..#.##..#.##.#.#.#..#...#.#...##...#.#..##..#.#..##....#....##...###.....#..#...#.....#....####...#
 #.....#..#...#.#..#..#.#...#.#...###..#...#.#.#.#...###..#.#...#.....####..#..#..#.###..###.....#.#
#..###.#.##.##..##...#.#..#..#.###....##.#...#..#..##...##..#.## ###.#.....# #..#..#...#.....####..#
 #.#.#.#.....#.#..##....#.#.#......###....###.#..#..#.#..#.##...#...#..#.##.#.#..#...#.#.####...#.# 
#..#..#.###.#..##.#.###..#....#####...##.#.....#..#...##.....##.#.#.#.##.#.....#..#.#...#...#.#.#.# 
#.# #...#..#..#........#...###......##...#.#.##.#.####..#.##..#...#..#...#.#.#.#.#.#..#.#.#...#.#..#
#.# #.#..#...##.#.#.##..###..#.#.###...##..#....#.....#.#..####.#..#.#.##.#..#...#...#..#..###..##.#
#..#...#...#...#..###..#...#...##....###.##..#.#..###.....#....#..#..#....#.# ###.#.#..#..#...#..#.#
#.#..#.###..##..##...#...#...#....#.#......##..#.##..###.##.##..#.#.#..#.#..##.....#..#..#..#..#.#.#
#.##.##...#...#.#..#..#.#.###.##.#.#.#.###..#.#.....#...#...# #..#..#.#.#..#...###.#.#..##.#..##...#
#...#...#..##.#..#..#.#.#.......#......#..#.#...###.#.#...##.#..#..#..#...#..###.#.#..#.#..#.#..##.#
 ##...## #..## #...#..#..#.#.##..#.##.#.#.#..#.#...#...#.#...#.#.#..#..#.#..#....#.##...#.##...#...#
#..##.#.#.#...#..#.#.# #.###..##.#..#...#.##.##..#.#.#.#.#.#...#.##..#.#.#.#..#.#....###..#..#.#.## 
#.##.#.....##..#..##..#.....#..#..##.##.#..#....##..#...#..####.....##.#...###...#.#.#.##.#.#..#.#.#
#......#.#...#..#...#.#.###..#..#.......##..####..#...##..#...###.###...#.#....#..##.#....#.#.#..#.#
#.#.##.##.##.#.#.##.#..#...#...#.#.#####...#....#.###.#..##.#...#....##.#...##.###...#.####..#..#..#
 #....#.....#......# #.##.#.###...#....#.#...###.....#..#...###.####..#..##.#.#....##......#...#..# 
#..##.#.#.#..#.#.#..#...#...#...#..#.#....#.#....#.##..#..##..#......#.#.#....#.###..###.#..###..#.#
 #..##...#.#..##.##..##..#.##.##.#...#####.##.####..#.#..#..#.#######.....#####.#.##....#.#.#...#..#
  #....#....#......#....#.........##..............#.....# #...........#.#.......#....##.......#...# 
   #### #### ###### #### #########  ############## #####   ########### # ####### ####  ####### ###  
