#############################################################
#P..|.#.#.#.#...#.........#.#.....#.................#.#...#.#
#.#.#.#.#.#.#.#####.#.#.#.#.#.#####.#.#.#.#####.#.#.#.#.#.#.#
#.|.|...........#.......#.......#...........#.....#.........#
#.#.#.#.#.#.#.#####.#.###.#.#.#.###.###.#######.###.#.###.#.#
#.#.#..R..#.#.#.#.#.#.#...........#...#.#.#.#...............#
###|###.#######.#.#.#.###.#.#.#.#.#.#####.###.#.###.#.#.#.###
#.#.|S#|#...........#.#.........#.#.#.#...........#.#.#.#...#
#.#.###.#.#####.#.#######.###.#.#.###.#.#.###.#.#######.#.#.#
#..S.|.S......#.....#.......#.#.#.#.........#.#...#.#.#.#.#.#
#.#.###.#.#######.#######.#.#########.#.#######.###.###.#.###
#...#...#.....#.#...#...#.....#.#.#.........#...............#
#.#.#.#######.#######.#.###.#.#.#####.#.###.#.#.###.###.#####
#...........#.#.#...#.............#.#.....#.....#...........#
###.#.#######.###.#####.#.#.#.#.#.#.###.#####.#####.###.#####
#.#.....#...#.......#.......#.#.......#.#.......#.#.........#
#.###.#####.###.#.###.#.#.###.#.#.#.#####.###.#####.###.###.#
#...#.#.#.......#.#.......#.#.....#.#.#.#...#.#.#.........#.#
#.#.#####.#.###.###.#.#.###.###.#######.#.#####.#.#.###.#.###
#.....#.....#.................#.#.#.#.......#.#.......#.....#
#.#.#####.###.#.#.#.###.###.#.#.#.#.###.#.###.###.#.#.###.###
#.#.#.#.#.#...............#.....#.........#.....#.......#.#.#
#.#.#.#.#####.#.#.###.#####.#.#.#.#.#.#.#####.#####.#####.#.#
#.#.......#.#.#.#.#.....#.....#.......#.#.#.....#.#.#.#.....#
#.#.#.#.#.#.#####.###.#####.###.#.#.#.#.#.###.###.###.###.#.#
#.#.#.#.......#.#...#.....#.#.....#.#.#.....#.#.........#...#
#.###.#.#.#.#.#.###.#.#.###.#.#.#.#.#####.###.###.#.#.#####.#
#.#.....#.#.....#.......#.#.#.#.......#...................#.#
###.#.###.#####.###.#.###.#######.#.#####.#####.#.#.#####.###
#.....#.......#.#.#.#.#.....#.........#.....#.#.#.#...#.....#
#.#.###.#.###.###.###.#.#.#.#.#########.###.#.#.###.#####.#.#
#...#.......#.#.................#.#.#.................#.....#
#.###.#.#.#.###.#.###.#.#.#.#.#.#.###.#.###.#.#.#.#.#####.#.#
#.#.....#.#.......................#.......#.#.......#...#.#.#
#.###.###.#.#.#.#.###.###.###.#.#####.#.#.###.###.#.#.#######
#...#...#.#.#.#.#.#.#...#.#.#...#.#.#.#.................#...#
#.###.#####.###.#.#.#.#####.###.###.#.#.#.###.#.#.#.#.###.###
#.......#...........#.#.#.................#.#.#.#.#...#.....#
#.###.#.###.#.#.#.#####.###.#.#.#.#.#.#.###.###.###.#####.#.#
#.#.....#.#.#.......#.....#.#.#.....#.#.#.....#.#...........#
#.#.#.#.#########.#.###.###.###.#.#.#.#####.#####.#.#.#.#.#.#
#.#.#.......#...#.#...#...#.......#.....#.#...#.........#.#.#
#######.#.#####.#.#####.###.###.###.#.###.###.###.###.###.#.#
#.#.#.......#.#.....#.......#.........#.........#.#.#.#.#...#
#.#.#.###.###.#.#.#.###.#.#.###.###.#.###.###.###.#####.#.#.#
#.................#.#.....#.#.#.#.....#.#.#.#.#.....#.......#
###.#.###.#####.#.#.###.#.#.#.###.#.###.#######.#.###.#.#.###
#.......#.#.#.#.........#.#.....#.#.#.....#.#.....#.........#
###.#.#.#####.#.#.#.###.###.#.###.#####.###.#.#.#.###.#.#.###
#.#.....#.#.....#.#.#.........#.#.#.#.#.#...#.#.....#.#.#...#
###.#.#.#.###.#####.#.###.#.#######.#.#####.#####.#.#.###.###
#...............#.....#.#.#...#.#.............#.............#
#.#.#.#.#.###.#.###.###.#.#.#######.#.#.#.#.#.###.#.#.###.#.#
#.#.....#.#.#.....#.#.#.......#.#.#.#...........#.#.#.#.#.#.#
#.#.#.#.#.#.#.#.#.###.###.#.#.###.#.#####.#.#.#######.#######
#.#.#.....#.............#.........#.#.......#.#.#.#.....#.#.#
#.#####.#####.#.#.###.###.#.#.###.#.###.#.#####.#.###.###.###
#...#.#.....#.....#.........#.#.....#.....#.................#
#####.#.#.###.#.#.#.#.#.#.#.#.###.#.###.#.#.###.###.#.###.#.#
#.#.........#...#.#.#.....#.....#.#.#...........#.......#...#
#############################################################
