#########   ########    
#.......#####......#    
#..................#    
#.......#####......#     
#######.#   ###.###   
      #.#     #.#       
      #.#     #.#      
      ###     #.#        
              #.#    
              #.#      
              #.#
###############.##############
#............................#
#............................#
#............................#
#............................#
#............................#
#............................#
#............................#
#............................#
##############################
