#####################
#...#.....#.......#.#
#.#.#.#.###.#.#####.#
#.#.#.#.......#.....#
#.#.###.###.###.###.#
#.........#.#.....#.#
#.#.###.###.#.#.#.###
#.#...#.#...........#
#####.#####.#.###.#.#
#.......#...#.#.#.#.#
#.###.#####.#####.#.#
#.......#.....#.....#
#.#.#.###.#.#####.###
#.#...#.....#.#.#...#
###.#.###.#######.#.#
#.......#.#.#.#.#...#
#.#.#.#####.#.#####.#
#...#.#.#.......#...#
#.#######.#.#.#####.#
#.....#...........#.#
#.#.#####.###.#.###.#
#.#.....#.#.#.......#
###.###.#.#.#.#.###.#
#.....#...........#.#
#.#.#####.#.#.#.###.#
#.#.#...#.#.#.#.#...#
#.#.#.###.###.#.#.#.#
#.#.#.......#.......#
#.#.###.#.#####.#.#.#
#.#.#.....#...#.....#
###.###.###.#####.#.#
#.....#.#.....#.#.#.#
#.#.#.#####.#.#.#####
#.#.......#.......#.#
#.#.#.#.#.###.#.#####
#.#.#.........#.#.#.#
#.###.#.#.#.#.#######
#.#.....#.........#.#
###.#####.#.###.#####
#.....#.....#.....#.#
#####################
