###########
#P....#...#
#.#.#.#|###
#.....#...#
#.#.###.###
#.........#
#.#.#####.#
#.....#...#
#.#.#.#.#.#
#.........#
###########
