###############################
#P....#.......................#
#.#.#.#|###...................#
#.....#...#...................#
#.#.###.############..........#
#.........|........########|###
#.#.#####.########.#..........#
#.....#...#........#..........#
#.#.#.#.#.#........#..R.......#
#.........#......R.#..........#
###########|########..........#
#.........#.#...R..#..........#
#..S......#.#......#.......S..#
#.........#.|...R..#..S.......#
#.S.......|.#......#..........#
###############################