#############################################################
#P..#...#.....#.#.#.....#.#.......#...........#.#.....#.....#
#.#.#.#####.#.#.#.###.###.#.###.#.#.###.#.###.#.#.#.###.#.#.#
#.......#.........#...#...................#.#.#.....#...#.#.#
#.#.###.#.#.#.#.###.#####.#.#.#.###.###.###.#.#.#.###.#.#####
#...#.......#.#.#.....#...........#...#...#.......#.........#
#.#####.#.###.#.###.#.###.###.#.###.#.###.###.#.#####.#.#.#.#
#...#.#.#.#.......#.....#.....#.#.......#.#.#.#.#.#.#.#.....#
###.#.#.###.#.#.#.###.#.#.#.###.#.###.###.#######.#.#####.###
#.......#...........#.#...#.#.......#.#.....#.#.#.....#.....#
###.#.#.###.#.###.#.###.#####.#.#####.###.###.#.###.#.###.###
#.....#.#.#...#.#.......#.#.#.....#...............#.....#...#
#.#.#####.###.#.###.###.#.###.#.###.#.###.#####.#####.#.#.#.#
#.#.#.#.........#...........#.........#.......#.#.#.......#.#
#.#####.#.#.#.#.#.#.#.#.#.#.#.#.###.#.#######.#.#.#####.#.#.#
#.#...........#.#...#.#.......#.#.........#.#.#.....#.....#.#
###.#.#.###.###.#####.#.###.#.#######.#.###.###.#.#####.#.#.#
#.......#.....#.#...#.............#.................#...#.#.#
###.###.###.#.###.#####.###.#.#####.#.#.###.###.#.###.#######
#...#.....#.........#.#.#.......#.........#.#.........#.#.#.#
#.#.###.#.###.###.###.#####.#.###.#.#.#.###.###.#.#####.#.#.#
#.....#.......#...#.......#.#.#...............#...#.#.#.....#
###.#####.###.#.###.#.#.#########.###.#.###.#.###.#.###.#.#.#
#...#.#.#...................#.#.....#.......#...#.........#.#
#.#########.#.#.###.###.#.###.###.#####.#.#########.#.#.#.###
#...#.#.#.....#.#.#.#.#.........#.#.#.#.........#...........#
#.#####.###.#######.###.#.###.#########.#.#####.#.###.#.#.###
#.#.#.........#...........#.#.#.#.#.#.......#.......#.#.#.#.#
#.#.###.###.#.###.#.#.#.#.#.#.#####.###.#.#####.#.#####.#####
#.........#.....................#...............#.#...#.#...#
#.#.#.#.#.###.###.###.###.#.#.#.###.###.#.###.###.#.#.###.#.#
#.......#.#...#.#...#.#.......#.#...#.#.#.#.............#...#
###.#.###########.#####.#.###########.#######.###.###.#.###.#
#.......#.#.#.#.#.#.#...................#.#.#.#.....#.....#.#
#.#.#####.#.#.#######.#.#####.###.###.###.#####.#######.#.###
#.#.#.#.#.......#.#.......#.#.#.....#.#...........#.#.#.....#
###.#.###.#.#.###.###.###.#.#####.#.#.###.###.#.#.#.#####.###
#.#.........#.#.....#.#.#.....#.#.#.....#.#...........#.#.#.#
#.#.#.###.###.#.#.#.#.#.###.#.#######.#####.#.#.#.#.###.###.#
#...........#.............#.....#.#.#...#.........#.#.......#
###.#.#######.#.#.#.#.#.#.#.#.###.#.#.#####.###.#.#.###.###.#
#.#.#...#.#.........#.#.......#.......#.#.#.#.#.......#...#.#
#.#.###.#####.###.#####.#.###.###.#.###.#.#.#.#.#.#.###.###.#
#.....#...#.#...#.#.#.....#.....#.#.................#.....#.#
#.#.#.###.#.#.#####.#.#.#####.#.#.#.#.#.#.#.#.#.#.#####.#.###
#...............#.......#.#.#...........#.....#.#.#...#.....#
###.#.#.#.#.#.#.#.#.#.###.#.###.#.#.#####.###.###.#.#####.###
#.#.#.#.#.#.#.......#...#...............#...#.#.......#...#.#
#####.#####.###.#.###.#.#.#.###.#.#.#######.#####.#.#.#.#.#.#
#.#.....#.....#.....#.#.....#.#.........#.......#.#.........#
###.#.#.#.#.#.###.#.#.###.#####.#.#.###.#.#.#######.#.#.###.#
#.....#.#.#.#.#.#.......#.#.#.....#.#.........#.#.....#.#.#.#
###.###.###.#.#.###.#.#####.#.#.#.#.###.#.#.#.#.###.#######.#
#.#.#.............#.#.........#.#.#.#.#.#.#.......#...#.#...#
###.#.#.#.#.#.#.###.#######.#.#.#.###.###.#.#.###.#####.###.#
#.............#.#.......#...................#.#.....#.......#
#.#.#.###.#.#.#.#.#.#####.#.###.#####.#.#.#####.#.###.#.###.#
#.#.....#.#.........#.#.......#...#.#.........#...#.....#.#.#
###.#.#####.#.#.#.###.#.#.#####.###.###.#.#######.###.#.#.#.#
#.......#.........#.......#.#.........#.........#.#.........#
#############################################################
