###########
#P....#...#
#.#.#.#|###
#.....#...#
#.#.###.############
#.........|........#
#.#.#####.########.#
#.....#...#........#
#.#.#.#.#.#........#
#.........#......R.#
####################
